"Titel"	"Opmerking"
"|EMMANUEL"	"Eigen naam test 8"
"|KOVACS"	"Rechter bij de CRvB"
"|HERRMANN"	"Raadsheer in de Hoge Raad"
"|CIVIC"	"Auto (Honda)"
"|GUNTER"	"Naam griffier bij de CRvB - MvO"
"|ZOON"	"Geen dochter"
"|ABO"	"afkorting voor abonnement"
"|DOKIC"	"achternaam komt in een ander verband voor op rechtspraak -JS"
"|WOMEN ON WAVES"	"naam komt voor in een ander verband - JS"
"|VERES"	"naam stichting - JS"
"|DEMETER"	"(archarisch bedrijf) en keurmerk  - JS"
"|TEHRANI"	"(Engels) dialect in het persisch/ komt een keer voor op rechtspraak.  JS"
"|ORLOV"	"1 uitspraak op rechtspraak waarin deze naam veelvoorkomt -JS"
"|PEKER"	"Achternaam - Komt 3 maal voor op rechtspraak. Geen verwijzingen naar de EHRM uitspraak - JS"
"|KARA"	"achternaam advocaat - JS"
"|SCHUMMER"	"achternaam advocaat die 3 keer voorkomt op rechtspraak"
"|LEGRAND"	"achternaam advocaat die twee keer voor op rechtspraak voorkomt. Geen enkele verwijzing naar de EHRM uitspraak - JS"
"|SCHUTH"	"achternaam advocaat die vaak voorkomt op rechtspraak - JS"
"|SUNBUL"	"achternaam advocaat die vaak voorkomt op rechtspraak - JS"
"|POPESCU"	"achternaam advocaat die vaak voorkomt op rechtspraak - JS"
"|GULER"	"achternaam advocaat die veel procedeert in sociale zekerheidszaken - JS"
"|BERGMANN"	"achternaam advocaat die veel procedeert in vreemdeling zaken - JS"
"|RAHMAN"	"achternaam advocaat die veel voorkomt op rechtspraak"
"|KLEYN"	"achternaam advocaat die veelvoorkomt op rechtspraak.nl- JS"
"|KAYA"	"achternaam advocaat en psychiater die geregeld voorkomen in rechtspraak - JS"
"|GRACA"	"achternaam advocaat- JS"
"|DARMON"	"achternaam A-G - JS"
"|HUGHES"	"achternaam arts/alias HvJ uitspraak ( C-9/02) - JS"
"|TOMIC"	"achternaam die driemaal op rechtspraak voorkomt in een ander verband - JS"
"|MLADIN"	"achternaam die in een ander verband voorkomt -JS"
"|PETROV"	"achternaam die in een ander verband voorkomt -JS"
"|ERGIN"	"achternaam die twee keer voorkomt. Geen verwijzing naar de uitspraak van het EHRM gevonden  -JS"
"|HUSSAIN"	"achternaam die vaak voorkomt- JS"
"|VAN GASTEL"	"achternaam die veel in een ander verband voorkomt - JS"
"|COSMAN"	"achternaam die veel in een ander verband voorkomt - JS"
"|DUDEK"	"achternaam die voorkomt -JS"
"|SUK"	"achternaam en afkorting die voorkomt op rechtspraak - JS"
"|MOULIN"	"achternaam en andere aanduidingen op rechtspraak - JS"
"|EWERT"	"achternaam en bedrijfsnaam - JS"
"|COX"	"achternaam en bedrijfsnaam - JS"
"|KOCH"	"achternaam en bedrijsnaam die vaak voorkomen in een ander verband"
"|SOARES"	"achternaam en gebruikte alias voor HR 19 december 2006, LJN AZ2101 - JS"
"|ULU"	"achternaam en naam van een moskee die voorkomen op rechtspraak - JS"
"|ANTONI"	"achternaam en naam van een school - JS"
"|JORDAN"	"achternaam en naam van school -JS"
"|SARKOZI"	"achternaam Franse president - JS"
"|GORSKI"	"achternaam gedragsdeskundige, twee uitspraken gevonden. Geen verwijzing naar de EHRM uitspraak gevonden - JS"
"|BENNETT"	"achternaam gemachtigde"
"|RAUSCH"	"achternaam gemachtigde - JS"
"|AKALIN"	"achternaam gemachtigde. Verwijzing naar de uitspraak van het EHRM niet gevonden -JS"
"|ARSLAN"	"achternaam gemachtigde/advocaat die veel voorkomt - JS"
"|SHARMA"	"achternaam griffier die vaak voorkomt op rechtspraak - JS"
"|DOBROV"	"achternaam griffier die zo'n 10 keer voorkomt op rechtspraak -JS"
"|JOSTEN"	"achternaam griffier en rechter die vaak voorkomt op rechtspraak - JS"
"|MARCON"	"achternaam in ander verband - JS"
"|DORE"	"achternaam in een ander verband -JS"
"|AYAN"	"achternaam komt in ander verband voor op rechtspraak - JS"
"|POLANSKI"	"achternaam komt in ander verband voor op rechtspraak - JS"
"|CHERIF"	"achternaam komt in een ander verband veel voor - JS"
"|MARTYNOV"	"achternaam komt op rechtspraak voor in een ander verband - JS"
"|KAHRAMAN"	"achternaam komt veelvuldig in ander verband voor op rechtspraak -JS"
"|YILDIZ"	"achternaam komt veelvuldig in ander verband voor op rechtspraak -JS"
"|RUMPF"	"achternaam komt voor in ander verband op rechtspraak - JS"
"|SOTI"	"achternaam komt voor in ander verband op rechtspraak - JS"
"|EMIN"	"achternaam komt voor in ander verband op rechtspraak - JS"
"|SOLOMUN"	"achternaam tolk - JS"
"|YORDANOVA"	"achternaam tolk die meerdere keren voorkomt op rechtspraak - JS"
"|FINKE"	"achternaam van advocaat die vaak voorkomt op rechtspraak -JS"
"|AYDIN"	"achternaam van advocaat en verzekeringsarts en bedrijfsnaam - JS"
"|MASSARO"	"achternaam van advocaat/gemachtigde die vaak voorkomt op rechtspraak -JS"
"|VOIGT"	"achternaam van een gemachtigde die in vele uitspraken voorkomt -JS"
"|BARKER"	"achternaam van een gemachtigde die veel voorkomt - JS"
"|SOKOLOV"	"achternaam wordt in een ander verband gebruikt - JS"
"|IPSEN"	"achternaam wordt in een ander verband gebruikt - JS"
"|KONYA"	"achternaam, plaatsnaam, naam ziekenhuis - JS"
"|EWALD"	"Achternaam. Komt 1 keer voor  op rechtspraak -JS"
"|WELLER"	"achternaam/bedrijfsnaam komt veel voor -JS"
"|LA ROSA"	"achternaam/naam cafï¿½ -JS"
"|SW"	"afkoring -JS"
"|SOW"	"afkorting - JS"
"|GATT"	"afkorting - JS"
"|BOZ"	"afkorting - JS"
"|CIN"	"afkorting - JS"
"|ABI"	"afkorting - JS"
"|GIC"	"afkorting - JS"
"|ION"	"afkorting - JS"
"|ORAC"	"afkorting - JS"
"|ABA"	"afkorting - JS"
"|GUR"	"afkorting - JS"
"|RINAS"	"afkorting - JS"
"|OZ"	"afkorting - JS"
"|VERK"	"afkorting - JS"
"|IVKO"	"afkorting - JS"
"|SOS"	"afkorting - JS"
"|BIBIC"	"afkorting - JS"
"|ISAR"	"afkorting - JS"
"|TUR"	"afkorting - JS"
"|AHO"	"afkorting - JS"
"|ARI"	"afkorting - JS"
"|TUS"	"afkorting - JS"
"|TAN"	"afkorting - JS"
"|SOVA"	"afkorting - JS"
"|GOS"	"afkorting - JS"
"|BAZ"	"afkorting - JS"
"|ALAY"	"afkorting - JS"
"|COC"	"afkorting - JS"
"|NIVA"	"afkorting - JS"
"|SAR"	"afkorting - JS"
"|ONG"	"afkorting - JS"
"|PLA"	"afkorting - JS"
"|ELO"	"afkorting - JS"
"|SIZ"	"afkorting - JS"
"|POSS"	"afkorting - JS"
"|ONK"	"afkorting - JS"
"|VO"	"afkorting - JS"
"|SERT"	"afkorting - JS"
"|BEC"	"afkorting - JS"
"|WEH"	"afkorting - JS"
"|SOC"	"afkorting - JS"
"|PIO"	"afkorting - JS"
"|BARIM"	"afkorting - JS"
"|AKA"	"afkorting - JS"
"|OLL"	"afkorting - JS"
"|SUR"	"afkorting - JS"
"|A.O."	"afkorting - JS"
"|ABAS"	"afkorting - JS"
"|URE"	"afkorting - JS"
"|BAMMER"	"afkorting - JS"
"|SIM"	"afkorting - JS"
"|WAIS"	"afkorting - JS"
"|O.A."	"afkorting - JS"
"|BATT"	"afkorting - JS"
"|c.c."	"afkorting - JS"
"|BICA"	"afkorting - JS"
"|Ari"	"afkorting - JS"
"|DIL"	"afkorting - JS"
"|ESIM"	"afkorting - JS"
"|VONA"	"afkorting - JS"
"|POA"	"afkorting - JS"
"|STEA"	"afkorting - JS"
"|SABO"	"afkorting - JS"
"|V. O."	"afkorting - JS"
"|KIT"	"afkorting - JS"
"|ARH"	"afkorting - JS"
"|GAK"	"afkorting - JS"
"|S.v."	"afkorting - JS"
"|LALO"	"afkorting - JS"
"|MOR"	"afkorting - JS"
"|BOAZ"	"afkorting - JS"
"|TRCO"	"afkorting - JS"
"|ATO"	"afkorting (Agrotechnologisch Onderzoek ) - JS"
"|BIK"	"afkorting (buitengerechtelijke incassokosten) - JS"
"|HIR"	"afkorting (herinvesteringsreserve) -JS"
"|WERZ"	"afkorting (komt maar 1 keer voor) - JS"
"|YER"	"afkorting die vaak voorkomt - JS"
"|DELIC"	"afkorting gebruikt in strafzaken -JS"
"|HAN"	"afkorting Hanze hogeschool -JS"
"|GOG"	"afkorting -JS"
"|BOVA"	"afkorting -JS"
"|MUT"	"afkorting -JS"
"|BUZA"	"afkorting -JS"
"|ACAT"	"afkorting -JS"
"|EGE"	"afkorting -JS"
"|ODI"	"afkorting -JS"
"|UNCU"	"afkorting -JS"
"|RIGO"	"afkorting onderzoek - JS"
"|BARD"	"afkorting voor Burgerlijk ambtenarenreglement defensie - JS"
"|GEDA"	"afkorting voor gedaagde - JS"
"|HELON"	"afkorting/ JS"
"|LEN"	"afkorting/bedrijfsnaam -JS"
"|RES"	"afkorting/Latijn - JS"
"|BACO"	"afkorting/naam - JS"
"|NART"	"afkorting/spelfout - JS"
"|TOK"	"afkorting/spelfout voor tolk - JS"
"|ETE"	"afkorting/typefout - JS"
"|N. N."	"afkorting/voorletters - JS"
"|HU"	"afkorting/voorletters - JS"
"|MD"	"afkorting/voorletters - JS"
"|B.c."	"afkorting/voorletters - JS"
"|I.B."	"afkorting/voorletters - JS"
"|I.A."	"afkorting/voorletters - JS"
"|C. B."	"afkorting/voorletters - JS"
"|I.O."	"afkorting/voorletters - JS"
"|M.O."	"afkorting/voorletters - JS"
"|F. W."	"afkorting/voorletters - JS"
"|AY"	"afkorting/voorletters - JS"
"|PY"	"afkorting/voorletters - JS"
"|J.-M. F."	"afkorting/voorletters - JS"
"|A.A."	"afkorting/voorletters - JS"
"|T.C."	"afkorting/voorletters - JS"
"|T.C.|H.C."	"afkorting/voorletters - JS"
"|X. S.A."	"afkorting/voorletters -JS"
"|N.TS."	"afkorting/voornaam - JS"
"|G.L. & S.L."	"afkortingen/voorletters - JS"
"|IVANOFF"	"alias ander uitspraak - JS"
"|ORIC"	"alias andere uitspraak - JS"
"|MASSON"	"alias andere uitspraak - JS"
"|STOKES"	"alias andere uitspraak - JS"
"|KARMAN"	"alias arrest HR - JS"
"|BIALEK"	"alias arrest HR - JS"
"|HUBER"	"alias arrest HR -JS"
"|AMANN"	"alias arrest HvJ"
"|FILEV"	"alias arrest HvJ - JS"
"|GEORGAKIS"	"alias arrest HvJ - JS"
"|GIRARD"	"alias arrest HvJ - JS"
"|BOYLE"	"alias arrest HvJ - JS"
"|LEHTONEN"	"alias arrest HvJ - JS"
"|FRANKOWSKI"	"alias arrest HvJ - JS"
"|CHRISTODOULOU"	"alias arrest HvJ - JS"
"|KARLSSON"	"alias arrest HvJ - JS"
"|FAURE"	"alias arrest HvJ - JS"
"|LEVIN"	"alias arrest HvJ - JS"
"|TUM"	"alias arrest HvJ - JS"
"|LOUKAS"	"alias arrest HvJ - JS"
"|PETROVA"	"alias arrest HvJ - JS"
"|FISCHER"	"alias arrest HvJ - JS"
"|ORLOWSKI"	"alias arrest HvJ - JS"
"|BALDWIN"	"alias arrest HvJ - JS"
"|PEACOCK"	"alias arrest HvJ - JS"
"|NILSSON"	"alias arrest HvJ - JS"
"|BALAZ"	"alias arrest HvJ - JS"
"|GENC"	"alias arrest HvJ - JS"
"|EROGLU"	"alias arrest HvJ - JS"
"|NOLD"	"alias arrest HvJ - JS"
"|SINGH"	"alias arrest HvJ - JS"
"|KEFALAS"	"alias arrest HvJ - JS"
"|MALIK"	"alias arrest HvJ - JS"
"|SKOMA"	"alias arrest HvJ - JS"
"|PICARO"	"alias arrest HvJ - JS"
"|NIKOLOVI"	"alias arrest HvJ - JS"
"|ACCARDO"	"alias arrest HvJ - JS"
"|SABOU"	"alias arrest HvJ - JS"
"|ROUARD"	"alias arrest HvJ - JS"
"|PFLEGER"	"alias arrest HvJ - JS"
"|FRANSSON"	"alias arrest HvJ - JS"
"|WEBB"	"alias arrest HvJ - JS"
"|KANTNER"	"alias arrest HvJ - JS"
"|BONDA"	"alias arrest HvJ - JS"
"|KEMPTER"	"alias arrest HvJ - JS"
"|VIDAL"	"alias arrest HvJ - JS"
"|NADLER"	"alias arrest HvJ - JS"
"|WELTE"	"alias arrest HvJ - JS"
"|DRAKE"	"alias arrest HvJ - JS"
"|ZUCHNER"	"alias arrest HvJ - JS"
"|FARRELL"	"alias arrest HvJ - JS"
"|SACCHI"	"alias arrest HvJ - JS"
"|KARNELL"	"alias arrest HvJ - JS"
"|LAGARDERE"	"alias arrest HvJ - JS"
"|ERDIL"	"alias arrest HvJ - JS"
"|WEIGEL"	"alias arrest HvJ (C-387/01) - JS"
"|LEROY"	"alias arrest HvJ-JS"
"|STEFF"	"alias arrest HvJ-JS"
"|SVENSSON"	"alias arrest HvJ-JS"
"|PARRY"	"alias arrest HvJ-JS"
"|DRAGOS"	"alias arrest HvJ-JS"
"|BARBIER"	"alias arrest HvJ-JS"
"|SEVINGER"	"alias arrest HvJ-JS"
"|KUC"	"alias arrest HvJ-JS"
"|TEDESCO"	"alias arrest HvJ-JS"
"|PARTRIDGE"	"alias arrest HvJ-JS"
"|ACCIARDI"	"alias arrest HvJ-JS"
"|AKDAS"	"alias HvJ (C-485/07) JS"
"|IOAN"	"alias HvJ (nr. C-402/09) JS"
"|GUNES"	"alias RvS uitspraak (LJN: BC6595)"
"|BOBEL"	"alias uitspraak HR (NJ 1994/300 ) -JS"
"|BAHCECI"	"alias uitspraak HR (NJ 2001/630)"
"|STROBEL"	"alias uitspraak HvJ"
"|SCHULZ"	"alias uitspraak HvJ - JS"
"|ABBEY"	"alias uitspraak HvJ - JS"
"|MANNINEN"	"alias uitspraak HvJ (C-319/02) - JS"
"|TATU"	"alias uitspraak HvJ (C-402/09) - JS"
"|CALISIR"	"alias uitspraak RvS - JS"
"|MARTINOVIC"	"alias van een andere uitspraak - JS"
"|JENKINSON"	"alias van een andere uitspraak - JS"
"|KRAJISNIK"	"alias van een andere uitspraak - JS"
"|STAKIC"	"alias van een andere uitspraak - JS"
"|FALCO"	"Amerikaanse torenvalk - JS"
"|WALLEN"	"amsterdam - JS"
"|ARAC"	"arac-software - JS"
"|GRIFHORST"	"arrest HR/veelvoorkomende achternaam"
"|SINCLAIR"	"artiest/alias arrest HvJ -JS"
"|HOOPER"	"artiest/veelvoorkomende achternaam -JS"
"|NAUS"	"arts - JS"
"|HOUGH"	"arts - JS"
"|TEODORESCU"	"arts - JS"
"|STOBER"	"auteur - JS"
"|RIIS"	"auteur - JS"
"|SACKER"	"auteur waarnaar verwezen wordt in voetnoot - JS"
"|HUMMER"	"auto - JS"
"|CAR"	"auto in het Engels/bedrijfsnaam - JS"
"|BORA"	"auto type - JS"
"|IANOS"	"auto type - JS"
"|SAFIRA"	"automerk/voornaam -JS"
"|SIK"	"baardje - JS"
"|KANE"	"band - JS"
"|BAN"	"bannen - NL woord - JS"
"|VAMOS"	"bedijfsnaam/afkorting - JS"
"|KONI"	"bedrijfnaam - JS"
"|SHER"	"bedrijfnaam - JS"
"|PIPER"	"bedrijfsnaam"
"|NOWAK"	"bedrijfsnaam - JS"
"|STAN"	"Bedrijfsnaam - JS"
"|VIT"	"bedrijfsnaam - JS"
"|MESSIER"	"bedrijfsnaam - JS"
"|SERES"	"bedrijfsnaam - JS"
"|BOHRER"	"bedrijfsnaam - JS"
"|SEVER"	"bedrijfsnaam - JS"
"|MEDIC"	"bedrijfsnaam - JS"
"|FIORE"	"bedrijfsnaam - JS"
"|GIZA"	"bedrijfsnaam - JS"
"|HADI"	"bedrijfsnaam - JS"
"|PECA"	"bedrijfsnaam - JS"
"|RIMER"	"bedrijfsnaam - JS"
"|BIRO"	"bedrijfsnaam - JS"
"|BELKA"	"bedrijfsnaam - JS"
"|SPICA"	"bedrijfsnaam - JS"
"|DALA"	"bedrijfsnaam - JS"
"|LONZA"	"bedrijfsnaam - JS"
"|MOLE"	"bedrijfsnaam - JS"
"|ATES"	"bedrijfsnaam - JS"
"|SALUS"	"bedrijfsnaam - JS"
"|RODIN"	"bedrijfsnaam - JS"
"|ALKIN"	"bedrijfsnaam - JS"
"|VAN MELLE"	"bedrijfsnaam - JS"
"|POLKA"	"bedrijfsnaam - JS"
"|ARZU"	"bedrijfsnaam - JS"
"|MOOREN"	"bedrijfsnaam - JS"
"|BAYER"	"bedrijfsnaam - JS"
"|NIELSEN"	"bedrijfsnaam - JS"
"|KESER"	"bedrijfsnaam - JS"
"|GALIC"	"bedrijfsnaam - JS"
"|GROZA"	"bedrijfsnaam - JS"
"|GRIB"	"bedrijfsnaam - JS"
"|ONUR"	"bedrijfsnaam - JS"
"|MUHLE"	"bedrijfsnaam - JS"
"|NURI"	"bedrijfsnaam - JS"
"|MIKA"	"bedrijfsnaam - JS"
"|AMER"	"bedrijfsnaam - JS"
"|RUPA"	"bedrijfsnaam - JS"
"|ATAS"	"bedrijfsnaam - JS"
"|AVRAM"	"bedrijfsnaam - JS"
"|HEUER"	"bedrijfsnaam - JS"
"|SERIN"	"bedrijfsnaam - JS"
"|FONTANA"	"bedrijfsnaam - JS"
"|VERITAS"	"bedrijfsnaam - JS"
"|KOFIN"	"bedrijfsnaam - JS"
"|REYHAN"	"bedrijfsnaam - JS"
"|BENFIELD"	"bedrijfsnaam - JS"
"|OWENS"	"bedrijfsnaam - JS"
"|BRADLEY"	"bedrijfsnaam - JS"
"|AMAC"	"bedrijfsnaam - JS"
"|NORBURY"	"bedrijfsnaam - JS"
"|KETTLE"	"bedrijfsnaam - JS"
"|GRUBER"	"bedrijfsnaam - JS"
"|PERRY"	"bedrijfsnaam - JS"
"|OREL"	"bedrijfsnaam - JS"
"|GRASSO"	"bedrijfsnaam - JS"
"|VIDA"	"bedrijfsnaam - JS"
"|CLEVE"	"bedrijfsnaam - JS"
"|MALMBERG"	"bedrijfsnaam - JS"
"|LIMONI"	"bedrijfsnaam - JS"
"|DE CLERCK"	"bedrijfsnaam - JS"
"|VAN HARN"	"bedrijfsnaam - JS"
"|PARADIS"	"bedrijfsnaam - JS"
"|SCHUTTE"	"bedrijfsnaam - JS"
"|DURA"	"bedrijfsnaam - JS"
"|SERIS"	"bedrijfsnaam - JS"
"|CUSTERS"	"bedrijfsnaam - JS"
"|KOCAK"	"bedrijfsnaam - JS"
"|PHILLIPS"	"bedrijfsnaam - JS"
"|ASITO"	"bedrijfsnaam - JS"
"|KWIATKOWSKI"	"bedrijfsnaam - JS"
"|CANPOLAT"	"bedrijfsnaam - JS"
"|SEPTA"	"bedrijfsnaam - JS"
"|KOHLER"	"bedrijfsnaam - JS"
"|GOBEL"	"bedrijfsnaam - JS"
"|HESSE"	"bedrijfsnaam - JS"
"|SEIDEL"	"bedrijfsnaam - JS"
"|HERIC"	"bedrijfsnaam - JS"
"|DEME"	"bedrijfsnaam - JS"
"|FALLER"	"bedrijfsnaam - JS"
"|McDONNELL"	"bedrijfsnaam - JS"
"|KRAL"	"bedrijfsnaam - JS"
"|DUDA"	"bedrijfsnaam - JS"
"|DEPA"	"bedrijfsnaam - JS"
"|CINAR"	"bedrijfsnaam - JS"
"|BORAK"	"bedrijfsnaam - JS"
"|DUMA"	"bedrijfsnaam - JS"
"|MAKSMA"	"bedrijfsnaam - JS"
"|HASS"	"bedrijfsnaam - JS"
"|MARES"	"bedrijfsnaam - JS"
"|CROCI"	"bedrijfsnaam - JS"
"|GECO"	"bedrijfsnaam - JS"
"|ZAFER"	"bedrijfsnaam - JS"
"|JALLOH"	"bedrijfsnaam - JS"
"|RIVIERE"	"bedrijfsnaam - JS"
"|SKARE"	"bedrijfsnaam - JS"
"|COLE"	"bedrijfsnaam - JS"
"|BEDI"	"bedrijfsnaam - JS"
"|REPAS"	"bedrijfsnaam - JS"
"|UPTON"	"bedrijfsnaam - JS"
"|KOSS"	"bedrijfsnaam - JS"
"|TIMAR"	"bedrijfsnaam - JS"
"|RAAB"	"bedrijfsnaam - JS"
"|BRAUN"	"bedrijfsnaam - JS"
"|MAUER"	"bedrijfsnaam - JS"
"|SIMA"	"bedrijfsnaam - JS"
"|BERNAT"	"bedrijfsnaam - JS"
"|ISIK"	"bedrijfsnaam - JS"
"|PACE"	"bedrijfsnaam - JS"
"|ROCHE"	"bedrijfsnaam - JS"
"|PERRIN"	"bedrijfsnaam - JS"
"|STORCK"	"bedrijfsnaam - JS"
"|DALAN"	"bedrijfsnaam - JS"
"|MALY"	"bedrijfsnaam - JS"
"|BUCK"	"bedrijfsnaam - JS"
"|AGIN"	"bedrijfsnaam - JS"
"|JUDE"	"bedrijfsnaam - JS"
"|MAKO"	"bedrijfsnaam - JS"
"|FAIRFIELD"	"bedrijfsnaam - JS"
"|BAKO"	"bedrijfsnaam - JS"
"|INDRA"	"bedrijfsnaam - JS"
"|ZANA"	"bedrijfsnaam - JS"
"|MERGER"	"bedrijfsnaam - JS"
"|MEJER"	"bedrijfsnaam - JS"
"|JOHANS"	"bedrijfsnaam - JS"
"|ATIK"	"bedrijfsnaam - JS"
"|RIVAS"	"bedrijfsnaam - JS"
"|MERIT"	"bedrijfsnaam - JS"
"|WEIL"	"bedrijfsnaam - JS"
"|KONIG"	"bedrijfsnaam - JS"
"|ASHWORTH"	"bedrijfsnaam - JS"
"|NIKKA"	"bedrijfsnaam - JS"
"|ROWE"	"bedrijfsnaam - JS"
"|KIEFER"	"bedrijfsnaam - JS"
"|RANDO"	"bedrijfsnaam - JS"
"|MOSCA"	"bedrijfsnaam - JS"
"|MONI"	"bedrijfsnaam - JS"
"|CASELLI"	"bedrijfsnaam - JS"
"|VARLEY"	"bedrijfsnaam - JS"
"|VERNON"	"bedrijfsnaam - JS"
"|BEDO"	"bedrijfsnaam - JS"
"|MARGUS"	"bedrijfsnaam - JS"
"|PREDA"	"bedrijfsnaam - JS"
"|ERI"	"bedrijfsnaam - JS"
"|VALMONT"	"bedrijfsnaam - JS"
"|PEREE"	"bedrijfsnaam - JS"
"|SHEFFIELD"	"bedrijfsnaam - JS"
"|DU BOIS"	"bedrijfsnaam - JS"
"|PENDRAGON"	"bedrijfsnaam - JS"
"|OLIVEIRA"	"bedrijfsnaam - JS"
"|NEW HORIZONS"	"bedrijfsnaam - JS"
"|DOYEN"	"bedrijfsnaam - JS"
"|BOWMAN"	"bedrijfsnaam - JS"
"|PELTZER"	"bedrijfsnaam - JS"
"|MACGREGOR"	"bedrijfsnaam - JS"
"|ARAL"	"bedrijfsnaam - JS"
"|STURM"	"bedrijfsnaam - JS"
"|ELLIOTT"	"bedrijfsnaam - JS"
"|JARRETT"	"bedrijfsnaam - JS"
"|ZIPPEL"	"bedrijfsnaam - JS"
"|REISZ"	"bedrijfsnaam - JS"
"|KEATING"	"bedrijfsnaam - JS"
"|PRESTON"	"bedrijfsnaam - JS"
"|MARRO"	"bedrijfsnaam - JS"
"|SABIC"	"bedrijfsnaam - JS"
"|WALCH"	"bedrijfsnaam - JS"
"|BUCHHOLZ"	"bedrijfsnaam - JS"
"|CANNON"	"bedrijfsnaam - JS"
"|LIEBESKIND"	"bedrijfsnaam - JS"
"|VENEZIA"	"bedrijfsnaam - JS"
"|BURTON"	"bedrijfsnaam - JS"
"|DAMM"	"bedrijfsnaam - JS"
"|MASER"	"bedrijfsnaam - JS"
"|TEE"	"bedrijfsnaam - JS"
"|KOZ"	"bedrijfsnaam - JS"
"|PRAGER"	"bedrijfsnaam - JS"
"|KOLLER"	"bedrijfsnaam - JS"
"|BORSE"	"bedrijfsnaam - JS"
"|MAXWELL"	"bedrijfsnaam - JS"
"|ZEIDLER"	"bedrijfsnaam - JS"
"|CONRADI"	"bedrijfsnaam - JS"
"|CURRIE"	"bedrijfsnaam - JS"
"|HOWDEN"	"bedrijfsnaam - JS"
"|MUSZKA"	"bedrijfsnaam - JS"
"|HAVA"	"bedrijfsnaam - JS"
"|TANKO"	"bedrijfsnaam - JS"
"|NAVARRA"	"bedrijfsnaam - JS"
"|HOLM"	"bedrijfsnaam - JS"
"|HEINZ"	"bedrijfsnaam - JS"
"|COLMAN"	"bedrijfsnaam - JS"
"|KUHLMAN"	"bedrijfsnaam - JS"
"|BERNSTORFF"	"bedrijfsnaam - JS"
"|DAX"	"bedrijfsnaam - JS"
"|VAES"	"bedrijfsnaam - JS"
"|KLASS"	"bedrijfsnaam - JS"
"|ISGRO"	"bedrijfsnaam - JS"
"|HOPIC"	"bedrijfsnaam - JS"
"|CLIFFORD"	"bedrijfsnaam - JS"
"|TODD"	"bedrijfsnaam - JS"
"|WAKEFIELD"	"bedrijfsnaam - JS"
"|CLERC"	"bedrijfsnaam - JS"
"|HAKANSSON"	"bedrijfsnaam - JS"
"|WARNER"	"bedrijfsnaam - JS"
"|HILTON"	"bedrijfsnaam - JS"
"|GITA"	"bedrijfsnaam - JS"
"|AKDOGAN"	"bedrijfsnaam - JS"
"|AGOSI"	"bedrijfsnaam - JS"
"|LAPLACE"	"bedrijfsnaam - JS"
"|RAYNER"	"bedrijfsnaam - JS"
"|HARMAN"	"bedrijfsnaam - JS"
"|TEMPLE"	"bedrijfsnaam - JS"
"|ADLER"	"bedrijfsnaam - JS"
"|LEIGH"	"bedrijfsnaam - JS"
"|VAN OOSTERWIJCK"	"bedrijfsnaam - JS"
"|ARTICO"	"bedrijfsnaam - JS"
"|KRAUSE"	"bedrijfsnaam - JS"
"|CARNE"	"bedrijfsnaam - JS"
"|BRUGGEMANN"	"bedrijfsnaam - JS"
"|SEIDL"	"bedrijfsnaam - JS"
"|HEINE"	"bedrijfsnaam - JS"
"|MIRON"	"bedrijfsnaam - JS"
"|MAFFEI"	"bedrijfsnaam - JS"
"|FRIGO"	"bedrijfsnaam - JS"
"|LOCHER"	"bedrijfsnaam - JS"
"|GALL"	"bedrijfsnaam - JS"
"|BERA"	"bedrijfsnaam - JS"
"|LOHUIS"	"bedrijfsnaam - JS"
"|BAT"	"bedrijfsnaam - JS"
"|EON"	"bedrijfsnaam - JS"
"|AMIE"	"bedrijfsnaam - JS"
"|DORR"	"bedrijfsnaam - JS"
"|SAL"	"bedrijfsnaam - JS"
"|LESSING"	"bedrijfsnaam - JS"
"|WEYHE"	"bedrijfsnaam - JS"
"|SASU"	"bedrijfsnaam - JS"
"|NADA"	"bedrijfsnaam - JS"
"|EFREMOV"	"bedrijfsnaam - JS"
"|SAHAP"	"bedrijfsnaam - JS"
"|SIEVERT"	"bedrijfsnaam - JS"
"|SORO"	"bedrijfsnaam - JS"
"|ZIMA"	"bedrijfsnaam - JS"
"|SULI"	"bedrijfsnaam - JS"
"|REYNOLDS"	"bedrijfsnaam - JS"
"|SAVIN"	"bedrijfsnaam - JS"
"|RIEDEL"	"bedrijfsnaam - JS"
"|YUMUSAK"	"bedrijfsnaam - JS"
"|OTO"	"bedrijfsnaam - JS"
"|WAJDNER"	"bedrijfsnaam - JS"
"|KAYAR"	"bedrijfsnaam - JS"
"|SOLARIS"	"bedrijfsnaam - JS"
"|CEDE"	"bedrijfsnaam - JS"
"|LAMBERTZ"	"bedrijfsnaam - JS"
"|PASKAL"	"bedrijfsnaam - JS"
"|LASKA"	"bedrijfsnaam / achternaam die voorkomt op rechtspraak - JS"
"|DE ROSA"	"bedrijfsnaam / straatnaam - JS"
"|WOLFF"	"bedrijfsnaam en achternaam - JS"
"|LAMBERT"	"bedrijfsnaam en achternaam - JS"
"|FLORE"	"bedrijfsnaam en achternaam - JS"
"|OBST"	"bedrijfsnaam en afkorting - JS"
"|ERGEN"	"bedrijfsnaam en komt voor in een citaat. Geen verwijzing naar de EHRM uitspraak gevonden -JS"
"|BLOCK"	"bedrijfsnaam en uitspraak van HvJ (nr. C-067/08 ) - JS"
"|OTTO"	"bedrijfsnaam -JS"
"|VOLTA"	"bedrijfsnaam -JS"
"|ORAL"	"bedrijfsnaam -JS"
"|TREVISAN"	"te veel foutpositieven MvO"
"|ARAS"	"bedrijfsnaam -JS"
"|FONTANESI"	"te veel foutpositieven MvO"
"|KHAN"	"bedrijfsnaam -JS"
"|DORIGO"	"te veel foutpositieven MvO"
"|SONDERGAARD"	"te veel foutpositieven MvO"
"|SHAW"	"bedrijfsnaam -JS"
"|DUCA"	"bedrijfsnaam -JS"
"|ROBSON"	"bedrijfsnaam -JS"
"|TAMM"	"bedrijfsnaam -JS"
"|HARRISON"	"bedrijfsnaam -JS"
"|TIMKO"	"bedrijfsnaam -JS"
"|SCHNEIDER"	"bedrijfsnaam -JS"
"|DOUGLAS"	"bedrijfsnaam -JS"
"|BOHLEN"	"bedrijfsnaam -JS"
"|KOVAL"	"bedrijfsnaam -JS"
"|DEVRIENDT"	"bedrijfsnaam -JS"
"|OGDEN"	"bedrijfsnaam -JS"
"|LIBERTY"	"bedrijfsnaam -JS"
"|PEAK"	"bedrijfsnaam -JS"
"|FOKA"	"bedrijfsnaam -JS"
"|INGRAM"	"bedrijfsnaam -JS"
"|SYKES"	"bedrijfsnaam -JS"
"|RHODES"	"bedrijfsnaam -JS"
"|KAMA"	"bedrijfsnaam -JS"
"|MIKO"	"bedrijfsnaam -JS"
"|GACON"	"bedrijfsnaam -JS"
"|SAK"	"bedrijfsnaam -JS"
"|JUHNKE"	"bedrijfsnaam -JS"
"|KANTAR"	"bedrijfsnaam -JS"
"|MOORE"	"bedrijfsnaam -JS"
"|BEAUCHAMP"	"bedrijfsnaam -JS"
"|MCKENZIE"	"bedrijfsnaam -JS"
"|SIRC"	"bedrijfsnaam -JS"
"|CUMMINS"	"bedrijfsnaam -JS"
"|MURRAY"	"bedrijfsnaam -JS"
"|SHARPE"	"bedrijfsnaam -JS"
"|RIAD"	"bedrijfsnaam -JS"
"|MADELA"	"bedrijfsnaam -JS"
"|BEIER"	"bedrijfsnaam -JS"
"|CICCOLELLA"	"bedrijfsnaam -JS"
"|DUMAS"	"bedrijfsnaam -JS"
"|TRIF"	"bedrijfsnaam -JS"
"|WAGNER"	"bedrijfsnaam, achternaam - JS"
"|POPPE"	"bedrijfsnaam/achternaam - JS"
"|LAMPE"	"bedrijfsnaam/achternaam -JS"
"|MACH"	"bedrijfsnaam/afkorting -JS"
"|MAS"	"bedrijfsnaam/afkorting -JS"
"|HILL"	"bedrijfsnaam/berg in het Engels/enzo - JS"
"|LEXA"	"bedrijfsnaam/datingsite - JS"
"|GREEN"	"bedrijfsnaam/groen in het Engels - JS"
"|BENEDIKT"	"bedrijfsnaam/heilige/plaats in Sloveniï¿½ - JS"
"|SUN"	"bedrijfsnaam/kan voorkomen in Engelse citaten"
"|NEU"	"bedrijfsnaam/komt voor in Duitse citaten - JS"
"|ILES"	"bedrijfsnaam/komt voor in Frans citaat -JS"
"|TURAN"	"bedrijfsnaam/stichting - JS"
"|CHURCHILL"	"bedrijfsnaam/veelvoorkomende achternaam - JS"
"|REID"	"bedrijfsnaam/veelvoorkomende achternaam -JS"
"|ALBERT"	"bedrijfsnaam/veelvoorkomende naam - JS"
"|KLAUS"	"bedrijfsnaam/veelvoorkomende naam - JS"
"|KING"	"bedrijfsnaam/veelvoorkomende naam - JS"
"|ACKERMANN"	"bedrijfsnaam/veelvoorkomende naam - JS"
"|BAILEY"	"bedrijfsnaam/veelvoorkomende naam - JS"
"|PICA"	"bedrijfsnaam/vogel - JS"
"|LICA"	"bedrijfsnaam/voornaam -JS"
"|ZARA"	"bedrijfsnaam/voornaam -JS"
"|SIKA"	"bedrijfsnamen - JS"
"|COMAN"	"bedrijfsnamen - JS"
"|KOMAR"	"bedrijfsnamen - JS"
"|SMITH"	"bedrijsnaam/veelvoorkomende achternaam - JS"
"|KUHN"	"bedrijventerrein in Nederland"
"|STEWART"	"beroep"
"|PAP"	"betekenis vader en veelvoorkomende afkorting voor diverse projecten en dergelijke -JS"
"|TURK"	"bevolking - JS"
"|LARI"	"bevolking -JS"
"|TRIPPEL"	"bier - JS"
"|ABRAHAM"	"bijbels personage -JS"
"|AGAR"	"bindmiddel - JS"
"|DALIA"	"bloem - JS"
"|ROOS"	"bloem - JS"
"|PERK"	"bloemenperk - JS"
"|ROMAN"	"boek - Js"
"|LIND"	"boom- JS"
"|DELTA"	"bouwwerk - JS"
"|GAS"	"brandstof - JS"
"|BRUGGER"	"brugklasser - JS"
"|AIRES"	"buenos aires - JS"
"|DONALDSON"	"buitenlandse onderneming die meerdere malen voorkomt op rechtspraak"
"|HADEP"	"buitenlandse politieke partij - JS"
"|LEVA"	"Bulgaarse munteenheid - JS"
"|AMARA"	"circus - JS"
"|CUBAN"	"cubaan in het Engels, bedrijfsnaam - JS"
"|VINCI"	"Da Vinci - JS"
"|SAMBA"	"dans - JS"
"|DE PITA"	"de pita-broodjes' komt voor op rechtspraak - JS"
"|VOS"	"dier - JS"
"|BOCK"	"dier/bier/achternaam die vaak voorkomt -JS"
"|VOGEL"	"dier/veelvuldig voorkomende achternaam -JS"
"|MUSKUS"	"dieren -JS"
"|BOK"	"diverse betekenissen"
"|BULLEN"	"diverse betekenissen - JS"
"|LANDEN"	"diverse betekenissen in het Nederlands - JS"
"|HET FINANCIEELE DAGBLAD B.v."	"diverse uitspraken waarin deze B.V. partij is"
"|WODKA"	"drank - JS"
"|JAGER"	"drank/gangbare achternaam - JS"
"|EXIM"	"Drie bedrijven met die naam. Geen verwijzing naar de EHRM uitspraak - JS"
"|KOMPAN"	"drie zaken op rechtspraak waarbij deze naam als bedrijfsnaam voorkomt en geen link heeft met de EHRM uitspraak - JS"
"|KOPIJ"	"drukwerk - JS"
"|KUCHE"	"duits woord - JS"
"|FRAU"	"duits woord - JS"
"|LEDERER"	"Duits woord/ kan in citaten voorkomen -JS"
"|FREITAG"	"Duits woord/ kan in citaten voorkomen -JS"
"|WOCH"	"duits woord/kan in citaat voorkomen - JS"
"|ARBEITER"	"Duits woord/kan in citaat voorkomen -JS"
"|ZWAR"	"duits woord/komt voor in citaat - JS"
"|FURCHT"	"Duits woord/komt voor in citaat - JS"
"|SCHLAGER"	"duitse muziek -JS"
"|JUG"	"een (water)kan -JS"
"|HAMMEL"	"een uitspraak waarin deze naam voorkomt in een ander verband"
"|WATT"	"eenheid - JS"
"|AURA"	"energieveld - JS"
"|ARAB"	"engels voor Arabier -JS"
"|MOON"	"Engels voor maan  / bedrijfsnaam - JS"
"|FRIEND"	"Engels voor vriend. Komt voor in citaten - JS"
"|GUN"	"Engels voor wapen/Nederlands werkwoord 'gunnen' -JS"
"|FINGER"	"engels woord - JS"
"|GRASS"	"engels woord - JS"
"|WILLS"	"engels woord - JS"
"|WARE"	"engels woord - JS"
"|NATIONAL"	"engels woord - JS"
"|SHINE"	"engels woord - JS"
"|MASS"	"engels woord - JS"
"|LAW"	"engels woord - JS"
"|LAY"	"engels woord - JS"
"|STORY"	"engels woord - JS"
"|URBAN"	"engels woord - JS"
"|WIDEN"	"engels woord - JS"
"|BALL"	"engels woord - JS"
"|FELL"	"engels woord - JS"
"|TRUNK"	"engels woord - JS"
"|RAW"	"engels woord - JS"
"|RUSHING"	"engels woord - JS"
"|SEVEN"	"engels woord - JS"
"|EGGS"	"engels woord - JS"
"|SILVER"	"engels woord - JS"
"|FREEDOM"	"engels woord -JS"
"|WICKS"	"engels woord -JS"
"|GRAMS"	"engels woord -JS"
"|FOX"	"engels woord -JS"
"|RUMOR"	"engels woord -JS"
"|MATTER"	"engels woord -JS"
"|HOOD"	"engels woord -JS"
"|CABLE"	"engels woord -JS"
"|TILES"	"engels woord -JS"
"|COKE"	"engels woord -JS"
"|LANE"	"engels woord -JS"
"|MANNERS"	"engels woord -JS"
"|FROM"	"engels woord -JS"
"|COOK"	"engels woord -JS"
"|FRAME"	"engels woord -JS"
"|BATTLE"	"engels woord -JS"
"|BILLING"	"engels woord -JS"
"|LINES"	"engels woord -JS"
"|CHILD"	"engels woord -JS"
"|BURNS"	"engels woord -JS"
"|MOODY"	"engels woord -JS"
"|GIVEN"	"engels woord -JS"
"|ENTER"	"engels woord -JS"
"|PRAY"	"engels woord -JS"
"|CAN"	"Engels woord. Kan voorkomen in citaten - JS"
"|BURY"	"Engels woord. Komt veel voor in citaten op rechtspraak. Geen verwijzingen naar de EHRM uitspraak gevonden -JS"
"|PAY"	"Engels woord/ kan voorkomen in citaten - JS"
"|BEARD"	"Engels woord/ kan voorkomen in citaten - JS"
"|TOWERS"	"Engels woord/ kan voorkomen in citaten - JS"
"|LUCK"	"Engels woord/ kan voorkomen in citaten - JS"
"|BURDEN"	"Engels woord/ kan voorkomen in citaten - JS"
"|CROOK"	"Engels woord/ kan voorkomen in citaten - JS"
"|GOLD"	"Engels woord/ kan voorkomen in citaten - JS"
"|WOOD"	"Engels woord/ kan voorkomen in citaten - JS"
"|PEAL"	"Engels woord/ kan voorkomen in citaten - JS"
"|PETROL"	"Engels woord/ kan voorkomen in citaten - JS"
"|RENDER"	"Engels woord/ kan voorkomen in citaten - JS"
"|JULY"	"Engels woord/ kan voorkomen in citaten - JS"
"|BROWN"	"Engels woord/kan in citaat voorkomen - JS"
"|CHAIR"	"Engels woord/kan in citaat voorkomen - JS"
"|SELF"	"Engels woord/kan in citaat voorkomen - JS"
"|DAY"	"Engels woord/kan in citaat voorkomen - JS"
"|WOODS"	"Engels woord/kan in citaat voorkomen - JS"
"|BAGEL"	"Engels woord/kan in citaat voorkomen - JS"
"|SALES"	"Engels woord/kan in citaat voorkomen - JS"
"|SMART"	"Engels woord/kan in citaat voorkomen - JS"
"|ASK"	"Engels woord/kan in citaat voorkomen - JS"
"|CROSS"	"Engels woord/kan in citaat voorkomen - JS"
"|PILL"	"Engels woord/kan in citaat voorkomen - JS"
"|HAS"	"Engels woord/kan in citaat voorkomen - JS"
"|WHITE"	"Engels woord/kan in citaat voorkomen - JS"
"|BANKS"	"Engels woord/kan in citaat voorkomen - JS"
"|YOUNG"	"Engels woord/kan in citaat voorkomen - JS"
"|BLACK"	"Engels woord/kan in citaat voorkomen - JS"
"|CREW"	"Engels woord/kan in citaat voorkomen - JS"
"|GAMBLE"	"Engels woord/kan in citaat voorkomen - JS"
"|NOSE"	"Engels woord/kan in citaat voorkomen - JS"
"|COP"	"Engels woord/kan in citaat voorkomen - JS"
"|SMAL"	"Engels woord/kan in citaat voorkomen - JS"
"|GRANT"	"Engels woord/kan in citaat voorkomen - JS"
"|GUEST"	"Engels woord/kan in citaat voorkomen - JS"
"|MUSIC"	"Engels woord/kan in citaat voorkomen - JS"
"|SALE"	"Engels woord/kan in citaat voorkomen - JS"
"|DREW"	"Engels woord/kan in citaat voorkomen - JS"
"|LOVE"	"Engels woord/kan in citaat voorkomen - JS"
"|GRILL"	"Engels woord/kan in citaat voorkomen - JS"
"|CZECH"	"Engels woord/kan in citaat voorkomen - JS"
"|WALL"	"Engels woord/kan in citaat voorkomen - JS"
"|STRAIN"	"Engels woord/kan in citaat voorkomen - JS"
"|INDEPENDENT NEWS"	"Engels woord/kan in citaat voorkomen - JS"
"|DEMOCRACY"	"Engels woord/kan in citaat voorkomen - JS"
"|GROSS"	"Engels woord/kan in citaat voorkomen - JS"
"|BACK"	"Engels woord/kan in citaat voorkomen - JS"
"|CARRIES"	"Engels woord/kan in citaat voorkomen - JS"
"|BASIC"	"Engels woord/kan in citaat voorkomen - JS"
"|CLOSE"	"Engels woord/kan in citaat voorkomen - JS"
"|RADIO FRANCE"	"Engels woord/kan in citaat voorkomen - JS"
"|GLASS"	"Engels woord/kan in citaat voorkomen - JS"
"|GREY"	"Engels woord/kan in citaat voorkomen -JS"
"|FIX"	"Engels woord/kan in citaten voorkomen= JS"
"|CREDIT"	"Engels woord/komt in citaten voor -JS"
"|OFFICIAL RECEIVER"	"Engelse/komt voor in citaten-JS"
"|RAI"	"evenementencentrum in Amsterdam bv: Auto Rai / JS"
"|TUNC"	"ex tunc toetsing - JS"
"|FALK"	"falk courier"
"|MELA"	"festival - JS"
"|SOLAR"	"festival - JS"
"|HEIDEGGER"	"filosoof - JS"
"|SCHELLING"	"filosoof/oude Nederlandse munt - JS"
"|ELCI"	"foutieve verwijzing naar ECLI. Komt veel voor op rechtspraak - JS"
"|TETE"	"frans woord - JS"
"|TU"	"frans woord - JS"
"|BEAU"	"Frans woord/ kan in citaten voorkomen -JS"
"|FERA"	"Frans woord/ omt voor in citaat - JS"
"|LEAU"	"Frans woord/kan in citaat voorkomen"
"|FORTE"	"Frans woord/kan in citaat voorkomen -JS"
"|ROUX"	"Frans woord/komt voor in citaat -JS"
"|LE PETIT"	"frans/ kan in citaat voorkomen - JS"
"|APPEL"	"fruit/ - JS"
"|MANGO"	"fruit/bedrijfsnaam - JS"
"|SCHMIDT"	"gangbare achternaam - JS"
"|HUNT"	"gangbare achternaam - JS"
"|MANNER"	"gangbare achternaam - JS"
"|AYGUL"	"gangbare achternaam - JS"
"|VANDER VELDE"	"gangbare achternaam -JS"
"|SMITS"	"gangbare achternaam -JS"
"|JACOB"	"gangbare naam - JS"
"|NOVAK"	"gangbare voornaam - JS"
"|OLIVER"	"gangbare voornaam -JS"
"|JESSE"	"gangbare voornaam-JS"
"|EROL"	"gangbare voornaam-JS"
"|FABIAN"	"gangbare voornaam-JS"
"|BAS"	"gangbare voornaam-JS"
"|MATE"	"gebruikelijk Nederlands woord - JS"
"|KLEIN"	"gebruikelijk woord en achternaam -JS"
"|WELKE"	"gebruikelijk woord -JS"
"|JUNG"	"gebruikelijke achternaam/bedrijfsnaam - JS"
"|FRANK"	"gebruikelijke voor- en achternaam - JS"
"|KAY"	"gebruikelijke voor- en achternaam - JS"
"|ADAM"	"gebruikelijke voor- en achternaam - JS"
"|MELIS"	"gebruikelijke voor- en achternaam - JS"
"|MARIN"	"gebruikelijke voornaam"
"|SHANNON"	"gebruikelijke voornaam -JS"
"|BINDER"	"gebruiksvoorwerp - JS"
"|TONER"	"gebruiksvoorwerp -JS"
"|DATA"	"gegevens - JS"
"|PEREIRA"	"geneesmiddel/achternaam die in een ander verband voorkomt - JS"
"|DONER"	"gerecht - JS"
"|CARBONARA"	"gerecht - JS"
"|MASSA"	"gewicht - JS"
"|KOREN"	"graan -JS"
"|KOS"	"Grieks eiland - JS"
"|MARIA"	"heilige/veelvoorkomende voornaam - JS"
"|KOP"	"hoofd/Nederlands woord -JS"
"|TUNIS"	"hoofdstad - JS"
"|KABUL"	"hoofdstad Afghanistan - JS"
"|WELLINGTON"	"hoofdstad van Nieuw-Zeeland - JS"
"|CARACAS"	"hoofdstad Venezuela - JS"
"|FLIEGER"	"horloge merk - JS"
"|KONRAD"	"horlogemerk - JS"
"|MATIES"	"in citaat komt het voor - vrienden - JS"
"|PETERMANN"	"Is een alias voor een uitspraak van de HR (HR 2 februari 2001, NJ 2001, 200)"
"|CHAMBER OF COMMERCE"	"Kamer van Koophandel in het Engels / te algemeen - JS"
"|NOVO"	"kan in ander verband voorkomen - JS"
"|THE SUNDAY TIMES"	"kan in andere zaken voorkomen - JS"
"|THE CREDIT"	"kan in engels citaat voorkomen - JS"
"|DELICATA"	"kan in italiaanse citaten voorkomen - JS"
"|HAAS"	"Kan ook als dier voorkomen - NVE"
"|KATA"	"karatesport"
"|WELSH"	"keltische taal - JS"
"|KISS"	"Kiss & Ride strook/ bedrijfsnaam enzo.. JS"
"|SMALL"	"klein in het Engels/ gangbare naam - JS"
"|ROSE"	"kleur/wijn/naam - JS"
"|JOBE"	"komt driemaal voor als achternaam van een tolk op rechtspraak -JS"
"|TORAN"	"komt in 1 uitspraak meerdere malen voor als de naam van een hond -JS"
"|BOZTAS"	"komt in 1 uitspraak meerdere malen voor als naam van een deskundige-JS"
"|THAW"	"komt in citaat voor - JS"
"|GLASBERG"	"komt in een ander verband voor - JS"
"|ITALIANO"	"komt in een ander verband voor -JS"
"|M. FAMILY"	"komt in een ander verband voor -JS"
"|OPEN DOOR"	"komt in een ander verband voor -JS"
"|D. GmbH"	"komt in een ander verband voor -JS"
"|SEVEN INDIVIDUALS"	"komt in een ander verband voor -JS"
"|KIS"	"komt in enkele uitspraken  voor als naam van een 'dagstrand' - JS"
"|SANOMA UITGEVERS B.V."	"komt in verschillend verband voor -JS"
"|GUT"	"komt vaak voor in citaten in het Duits op rechtspraak - JS"
"|ELLES"	"komt vaak voor in citaten in het Frans op rechtspraak - JS"
"|VILA"	"komt veelvuldig op rechtspraak voor als achternaam en plaatsnaam in Portugal -JS"
"|SAHIN"	"komt veelvuldig voor als verwijzing naar een uitspraak van het HvJ (arrest van 17 september 2009, C-242/06, Sahin) - JS"
"|IVANOV"	"komt vijf maal voor in een andere betekenis dan verwijzing naar de EHRM uitspraak - JS"
"|ONAL"	"komt voor als "" Trading Internati-onal N.V"". Wordt dit herkend door LX?"
"|SIMKA"	"komt voor als ""simka(a)rt(en)"" wordt dit herkend - JS?"
"|PETROVIC"	"komt voor als achternaam van getuige en tolk op rechtspraak -JS"
"|JAHNKE"	"komt voor als achternaam. Geen verwijzing naar de EHRM uitspraak gevonden - JS"
"|KOVAC"	"komt voor als een naam van een gemachtigde - JS"
"|HATTON"	"komt voor als Hatton II. Dat onderscheid wordt niet gemaakt in de excel lijst - JS"
"|DPL"	"komt voor als kenteken en afkorting van de Dienst Personeel en Logistie van de KLPD"
"|WULFF"	"komt voor als naam in een strafzaak - JS"
"|EDER"	"komt voor als oefenterrein van defensie in een uitspraak en enkele uitspraken met spelfouten voor 'ieder' - JS"
"|NIKOLIC"	"komt voor als straatnaam/plaatsnaam - JS"
"|ARAZ"	"komt voor als voor- en achternaam op rechtspraak - JS"
"|AKAN"	"komt voor als voornaam -JS"
"|RUGA"	"komt voor als woord in medische zaak -JS"
"|SALVATORE"	"komt voor als woord/beeldmerk - JS"
"|IKE"	"komt voor in citaat - JS"
"|VIDAS"	"komt voor in citaat - JS"
"|KITA"	"komt voor in citaat - JS"
"|BUTA"	"komt voor in citaat - JS"
"|PUZ"	"komt voor in citaat - JS"
"|METE"	"komt voor in citaat - JS"
"|DOSEN"	"komt voor in citaat - JS"
"|MAASS"	"komt voor in citaat - JS"
"|ANGUELOV"	"komt voor in citaat - JS"
"|BASKAN"	"komt voor in citaat - JS"
"|PODER"	"komt voor in citaat - JS"
"|OLAH"	"komt voor in citaat - JS"
"|NOTAR"	"komt voor in citaat - JS"
"|MABEY"	"komt voor in citaat - JS"
"|STOPP"	"komt voor in citaat - JS"
"|TIID"	"komt voor in citaat - JS"
"|SONGER"	"komt voor in citaat - JS"
"|SALLAM"	"komt voor in citaat - JS"
"|DURANTE"	"komt voor in citaat - JSW"
"|CONTA"	"komt voor in citaat / tegen - JS"
"|STATI"	"komt voor in citaten in het Italiaans of als afkorting - JS"
"|MUCHA"	"komt voor in citaten -JS"
"|BABES"	"komt voor in de Engelse betekenis op rechtspraak"
"|RAUS"	"komt voor in Duits citaat -JS"
"|WOHL"	"komt voor in Duits citaat -JS"
"|STALL"	"komt voor in Duitse citaten -JS"
"|TIMES NEWSPAPERS LTD"	"komt voor in een citaat"
"|TETSEN"	"komt voor in een citaat - JS"
"|GERDEN"	"komt voor in een citaat - JS"
"|LETER"	"komt voor in een Engels citaat - JS"
"|MAILLARD"	"komt voor in Engels citaat -JS"
"|BOUND"	"komt voor in Engels citaat -JS"
"|MANIC"	"komt voor in Engels citaat -JS"
"|PURGER"	"komt voor in Frans citaat - JS"
"|HEBERGER"	"komt voor in frans citaat - JS"
"|AGEE"	"komt voor in frans citaat - JS"
"|FOCO"	"komt voor in Italiaans citaat - JS"
"|ATTI"	"komt voor in Italiaans citaat/ en  achternaam niet zijde de EHRM uitspraak - JS"
"|HADDAD"	"komt voor in meerdere uitspraken op rechtspraak - JS"
"|VAN ANRAAT"	"komt voor in meerdere uitspraken op rechtspraak - JS"
"|REALE"	"komt voor in Spaanse citaten -JS"
"|RIVERA"	"komt zeven maal voor als bedrijfsnaam danwel achternaam op rechtspraak -JS"
"|FINANCIAL TIMES LTD"	"Krant/veelvoorkomend - JS"
"|DALI"	"kunstschilder/bedrijfsnaam -JS"
"|PLAZA"	"? heeft geen unicode decompositie (L + /)"
"|OZON"	"laag in stratosfeer -JS"
"|SUDAN"	"land -JS"
"|HOLLAND"	"Land/bedrijfsnaam -JS"
"|ERAT"	"Latijn - JS"
"|FRANKO"	"leveringsconditie' gebruikt in ruim 15 uitspraken -JS"
"|KIN"	"lichaamsdeel -JS"
"|HYDE PARK"	"locatie in Londen - JS"
"|AIR CANADA"	"luchtvaartmaatschappij - JS"
"|PFEIFFER"	"medische aandoening - JS"
"|BOWEN"	"medische aandoening - JS"
"|STEC"	"medische afkorting -JS"
"|GOLDMANN"	"medische onderzoeksterm - JS"
"|LHERMITTE"	"medische term"
"|SHUB"	"medische term"
"|RAMUS"	"medische term - JS"
"|BARRETT"	"medische term - JS"
"|CONUS"	"medische term -JS"
"|OOMS"	"meervoud oom"
"|SPAS"	"meervoud spa - JS"
"|BASHAN"	"merk van een quad - JS"
"|THOMPSON"	"merk wapen - JS"
"|SEN"	"merk/afkorting - JS"
"|DEAN"	"merk/engels woord dat in citaten kan voorkkomen -JS"
"|MATIC"	"merknaam - JS"
"|ATILLA"	"merknaam - JS"
"|SENKO"	"merknaam - JS"
"|NOLAN"	"merknaam - JS"
"|ROHNER"	"merknaam - JS"
"|SIZER"	"merknaam - JS"
"|KNEIPP"	"merknaam - JS"
"|FORD"	"merknaam - JS"
"|ACAR"	"merknaam - JS"
"|CERUTI"	"merknaam - JS"
"|GIANNI"	"merknaam - JS"
"|BOSCH"	"merknaam - JS"
"|ARMA"	"merknaam - JS"
"|LEE"	"merknaam - JS"
"|FENDI"	"merknaam - JS"
"|GAULTIER"	"merknaam - JS"
"|BIBI"	"merknaam - JS"
"|KNORR"	"merknaam - JS"
"|MASSEY"	"merknaam - JS"
"|REISSE"	"merknaam - JS"
"|JURA"	"merknaam - JS"
"|PERONI"	"merknaam - JS"
"|LEVI"	"merknaam - JS"
"|GERBER"	"merknaam - JS"
"|GIORGIO"	"merknaam - JS"
"|CROSSLAND"	"merknaam - JS"
"|ERIKSON"	"merknaam - JS"
"|EASTON"	"merknaam - JS"
"|MARINO"	"merknaam - JS"
"|BONAPART"	"merknaam - JS"
"|ALBE"	"merknaam - JS"
"|HENRA"	"merknaam - JS"
"|ZIPPER"	"merknaam - JS"
"|ERICSSON"	"merknaam - JS"
"|BOSSI"	"merknaam - JS"
"|TERRANOVA"	"merknaam - JS"
"|REISS"	"merknaam - JS"
"|ERIKSSON"	"merknaam - JS"
"|JAKOBSEN"	"merknaam - JS"
"|WICK"	"merknaam - JS"
"|O'NEILL"	"merknaam - JS"
"|FERRARO"	"merknaam - JS"
"|DAVIDSON"	"merknaam - JS"
"|MARLEY"	"merknaam - JS"
"|NORRIS"	"merknaam - JS"
"|FEYA"	"merknaam - JS"
"|MILKA"	"merknaam - JS"
"|SEGA"	"merknaam - JS"
"|PUKY"	"merknaam - JS"
"|WILKINSON"	"merknaam -JS"
"|BIC"	"merknaam -JS"
"|BATA"	"merknaam -JS"
"|KANZI"	"merknaam -JS"
"|KENT"	"merknaam -JS"
"|MOLTENI"	"merknaam -JS"
"|JENNINGS"	"merknaam -JS"
"|CALLI"	"merknaam -JS"
"|ANSCHUTZ"	"merknaam -JS"
"|SCHIESSER"	"merknaam -JS"
"|ROCH"	"merknaam -JS"
"|CORRADO"	"merknaam -jS"
"|CANALI"	"merknaam -JS"
"|VICARIO"	"merknaam. Komt eenmaal voor op rechtspraak. Verwijzing naar de EHRM uitspraak niet gevonden -JS"
"|MORA"	"merknaam/achternaam - JS"
"|BONE"	"merknaam/achternaam/bedrijfsnaam -JS"
"|FILO"	"merknaam/afkorting e.d. -JS"
"|VAILLANT"	"merknaam/bedrijfsnaam - JS"
"|JOHNSON"	"merknaam/veelvoorkomende achternaam - JS"
"|COOPER"	"merknaam/veelvoorkomende achternaam - JS"
"|FALLON"	"merknaam-JS"
"|RITTER"	"merknaam-JS"
"|MODER"	"moeder in het Zweeds/komt voor op rechtspraak anders dan de EHRM uitspraak"
"|BEK"	"mond/veelvuldig voorkomende achternaam -JS"
"|FRANC"	"munteenheid - JS"
"|WEISSMAN"	"museum - JS"
"|BASS"	"muziekinstrument -JS"
"|HORNBY"	"naam  komt in een ander verband voor -JS"
"|ZIVKOVIC"	"naam advocaat - JS"
"|GUNGORMEZ"	"naam advocaat - JS"
"|TOMAS"	"naam advocaat - JS"
"|MECHE"	"naam advocaat - JS"
"|FUCHS"	"naam advocaat - JS"
"|ISAAK"	"naam advocaat - JS"
"|ENAIT"	"naam advocaat - JS"
"|BOYCE"	"naam advocaat - JS"
"|GRIFFITHS"	"naam advocaat - JS"
"|KILIC"	"naam advocaat - JS"
"|EKHOLM"	"naam advocaat - JS"
"|LEMKE"	"naam advocaat - JS"
"|ANIK"	"naam advocaat - JS"
"|ARSLANER"	"naam advocaat - JS"
"|TUMA"	"naam advocaat - JS"
"|PETRESCU"	"naam advocaat - JS"
"|UNSAL"	"naam advocaat - JS"
"|TANER"	"naam advocaat - JS"
"|CEVIK"	"naam advocaat - JS"
"|ACUN"	"naam advocaat - JS"
"|SIMONOVA"	"naam advocaat - JS"
"|YESILGOZ"	"naam advocaat - JS"
"|TAMER"	"naam advocaat - JS"
"|ROBER"	"naam advocaat - JS"
"|KEZER"	"naam advocaat - JS"
"|SELCUK"	"naam advocaat - JS"
"|CEYLAN"	"naam advocaat - JS"
"|TANIS"	"naam advocaat - JS"
"|JORGENSEN"	"naam advocaat - JS"
"|BENAMAR"	"naam advocaat - JS"
"|REILLY"	"naam advocaat - JS"
"|NOE"	"naam advocaat - JS"
"|ALTUN"	"naam advocaat - JS"
"|BLUM"	"naam advocaat - JS"
"|ISSA"	"naam advocaat - JS"
"|KELLNER"	"naam advocaat - JS"
"|LOTTER"	"naam advocaat - JS"
"|DEMPSEY"	"naam advocaat - JS"
"|SCHRIEDER"	"naam advocaat - JS"
"|CAKICI"	"naam advocaat - JS"
"|OZGUL"	"naam advocaat - JS"
"|SEARLE"	"naam advocaat - JS"
"|PUTZ"	"naam advocaat - JS"
"|HINS"	"naam advocaat - JS"
"|BUCHNER"	"naam advocaat - JS"
"|SCHERER"	"naam advocaat - JS"
"|NASS"	"naam advocaat - JS"
"|DEMMER"	"naam advocaat - JS"
"|SAADE"	"naam advocaat - JS"
"|SIMONETTI"	"naam advocaat - JS"
"|BERNS"	"naam advocaat - JS"
"|MAIR"	"naam advocaat - JS"
"|RYDER"	"naam advocaat - JS"
"|BOHLER"	"naam advocaat - JS"
"|KRUSE"	"naam advocaat - JS"
"|MERSCH"	"naam advocaat - JS"
"|TASPINAR"	"naam advocaat - JS"
"|DURDU"	"naam advocaat - JS"
"|MATER"	"naam advocaat - JS"
"|LENGYEL"	"naam advocaat - JS"
"|ANTIC"	"naam advocaat - JS"
"|SWENNEN"	"naam advocaat - JS"
"|OZSUREN"	"naam advocaat - JS"
"|DURMUS"	"naam advocaat - JS"
"|OZKARA"	"naam advocaat - JS"
"|SAPMAZ"	"naam advocaat - JS"
"|ALIM"	"naam advocaat - JS"
"|SARITAS"	"naam advocaat - JS"
"|DREYER"	"naam advocaat - JS"
"|PETKOVIC"	"naam advocaat en tolk - JS"
"|YIGIT"	"naam advocaat -JS"
"|VLADIMIROVA"	"naam advocaat/gemachtigde - JS"
"|HANUS"	"naam advocaat/gemachtigde - JS"
"|STUMPE"	"naam advocaat/gemachtigde - JS"
"|KOLEV"	"naam advocaat/gemachtigde - JS"
"|PETKOVSKI"	"naam advocaat/gemachtigde - JS"
"|DUR"	"naam advocaat/gemachtigde - JS"
"|FOY"	"naam advocaat/gemachtigde - JS"
"|CRISTIAN"	"naam advocaat/partij - JS"
"|HUTCHINSON"	"naam arts - JS"
"|EMERY"	"naam arts - JS"
"|DEPAUW"	"naam arts - JS"
"|FIALA"	"naam arts - JS"
"|POLAT"	"naam arts - JS"
"|MOSER"	"naam arts - JS"
"|PIETRO"	"naam arts - JS"
"|TITIZ"	"naam arts - JS"
"|ERGUN"	"naam arts - JS"
"|SAYIN"	"naam arts - JS"
"|STRAKA"	"naam arts - JS"
"|ECKER"	"naam arts - JS"
"|LECHNER"	"naam arts - JS"
"|AZIZ"	"naam arts - JS"
"|DOERGA"	"naam arts - JS"
"|HUBNER"	"naam arts - JS"
"|CONSTANTINI"	"naam arts - JS"
"|KUMMER"	"naam arts - JS"
"|ENDERS"	"naam arts - JS"
"|BUSCH"	"naam arts - JS"
"|YOKUS"	"naam arts - JS"
"|HOLZER"	"naam arts - JS"
"|HAUER"	"naam arts - JS"
"|FAIZ"	"naam arts - JS"
"|BISH"	"naam arts - JS"
"|FRICK"	"naam arts - JS"
"|SAMIM"	"naam arts - JS"
"|FOURNIER"	"naam arts - JS"
"|LUBERTI"	"naam arts - JS"
"|VAN DROOGENBROECK"	"naam arts - JS"
"|GLIMMERVEEN"	"naam arts - JS"
"|OFNER"	"naam arts - JS"
"|BRUS"	"naam arts - JS"
"|METS"	"naam arts - JS"
"|NASSERI"	"naam arts - JS"
"|OSTENDORF"	"naam arts - JS"
"|BOZKIR"	"naam arts - JS"
"|GUZELER"	"naam arts - JS"
"|KURTH"	"naam arts - JS"
"|BABIAK"	"naam arts - JS"
"|SOSINOWSKA"	"naam arts - JS"
"|FATHI"	"naam arts die meerdere malen voorkomt - JS"
"|PAVLOV"	"naam arts die veelvuldig voorkomt - JS"
"|HADJI"	"naam arts en tolk -JS"
"|MACHON"	"naam arts -JS"
"|ATALAY"	"naam arts -JS"
"|KLOSE"	"naam arts -JS"
"|LEBER"	"naam arts -JS"
"|CAVALLO"	"naam arts -JS"
"|USTA"	"naam arts -JS"
"|TUNCA"	"naam arts -JS"
"|OSHER"	"naam arts -JS"
"|STARK"	"naam arts -JS"
"|SCHAEFER"	"naam arts -JS"
"|MAUGERI"	"naam arts -JS"
"|NAGLER"	"naam arts -JS"
"|INAL"	"naam arts -JS"
"|TRAN"	"naam arts -JS"
"|LOMBARDO"	"naam arts -JS"
"|BERISHA"	"naam arts -JS"
"|DONOVAN"	"naam arts -JS"
"|OYMAN"	"naam arts -JS"
"|LUPINA"	"naam arts -JS"
"|PETRE"	"naam arts -JS"
"|KARACA"	"naam arts -JS"
"|GOSSELIN"	"naam arts -JS"
"|AKDENIZ"	"naam arts -JS"
"|LATIMER"	"naam arts -JS"
"|MATHERON"	"naam arts -JS"
"|KOPF"	"naam arts -JS"
"|NIKOLOV"	"naam arts komt 1 keer voor op rechtspraak. Verwijzing naar de EHRM uitspraak niet gevonden."
"|ERDEN"	"naam arts/spelfout voor reden -JS"
"|JONSSON"	"naam auteur - JS"
"|KIRK"	"naam auteur - JS"
"|FRIEDL"	"naam auteur - JS"
"|REYNTJENS"	"naam auteur - JS"
"|RIEME"	"naam auteur - JS"
"|CALLENS"	"naam auteur - JS"
"|LEHNER"	"naam auteur - JS"
"|NIMMO"	"naam auteur - JS"
"|DREHER"	"naam auteur - JS"
"|ARROWSMITH"	"naam auteur - JS"
"|FOCKO"	"naam auteur - JS"
"|SALAMON"	"naam auteur - JS"
"|SUSINI"	"naam auteur -JS"
"|BURCA"	"naam auteur -JS"
"|McCAUGHEY"	"naam auteur -JS"
"|KORMOS"	"naam auteur -JS"
"|SPATH"	"naam auteur -JS"
"|DENIZ"	"naam bank - JS"
"|BARCLAY"	"naam bank - JS"
"|COHEN"	"naam burgemeester Amsterdam -JS"
"|REINA"	"naam cafï¿½  en vliegveld - JS"
"|BELOV"	"naam deskundige - JS"
"|SARKOZY"	"naam franse president - JS"
"|LEMEL"	"naam ge"
"|FREITAS"	"naam gemachtigde - JS"
"|STEFANOVIC"	"naam gemachtigde - JS"
"|HEIDEMANN"	"naam gemachtigde - JS"
"|SAYA"	"naam gemachtigde - JS"
"|YAKISIR"	"naam gemachtigde - JS"
"|BALAZS"	"naam gemachtigde - JS"
"|NEMETH"	"naam gemachtigde - JS"
"|BENES"	"naam gemachtigde - JS"
"|ROMPA"	"naam gemachtigde - JS"
"|GUNEY"	"naam gemachtigde - JS"
"|WASSERMAN"	"naam gemachtigde - JS"
"|MELONI"	"naam gemachtigde - JS"
"|KARTAL"	"naam gemachtigde - JS"
"|DAVIES"	"naam gemachtigde - JS"
"|HAYES"	"naam gemachtigde - JS"
"|EISENBERGER"	"naam gemachtigde - JS"
"|PRODAN"	"naam gemachtigde - JS"
"|VITOLS"	"naam gemachtigde - JS"
"|IVANOVIC"	"naam gemachtigde - JS"
"|BODON"	"naam gemachtigde - JS"
"|WEDEKIND"	"naam gemachtigde - JS"
"|KAPLAN"	"naam gemachtigde - JS"
"|STEMPFER"	"naam gemachtigde - JS"
"|GRIGORIAN"	"naam gemachtigde - JS"
"|AIGNER"	"naam gemachtigde - JS"
"|TURI"	"naam gemachtigde - JS"
"|JOVIC"	"naam gemachtigde - JS"
"|MUTLU"	"naam gemachtigde - JS"
"|MANAK"	"naam gemachtigde - JS"
"|SEKER"	"naam gemachtigde - JS"
"|Sï¿½RENSEN"	"naam gemachtigde - JS"
"|TOPP"	"naam gemachtigde - JS"
"|ANDRIC"	"naam gemachtigde - JS"
"|BOLUK"	"naam gemachtigde - JS"
"|KALAY"	"naam gemachtigde - JS"
"|VOLF"	"naam gemachtigde - JS"
"|KOCER"	"naam gemachtigde - JS"
"|CALVO"	"naam gemachtigde - JS"
"|LOFFLER"	"naam gemachtigde - JS"
"|VAN DEN BOUWHUIJSEN"	"naam gemachtigde - JS"
"|BIRK"	"naam gemachtigde - JS"
"|SIEGA"	"naam gemachtigde - JS"
"|MANDIC"	"naam gemachtigde - JS"
"|BRONDA"	"naam gemachtigde - JS"
"|VERVERGAERT"	"naam gemachtigde - JS"
"|TALI"	"naam gemachtigde - JS"
"|MAYR"	"naam gemachtigde - JS"
"|ENGDAHL"	"naam gemachtigde - JS"
"|KROPF"	"naam gemachtigde - JS"
"|ARZT"	"naam gemachtigde - JS"
"|VAN DER LINDEN VOOREN"	"naam gemachtigde - JS"
"|SEPP"	"naam gemachtigde - JS"
"|ELMAS"	"naam gemachtigde - JS"
"|MONTOYA"	"naam gemachtigde - JS"
"|PAULI"	"naam gemachtigde - JS"
"|MCLEAN"	"naam gemachtigde - JS"
"|NEIJ"	"naam gemachtigde - JS"
"|LEW"	"naam gemachtigde - JS"
"|GUTMAN"	"naam gemachtigde - JS"
"|SARWARI"	"naam gemachtigde - JS"
"|POLZ"	"naam gemachtigde - JS"
"|GUVEC"	"naam gemachtigde -JS"
"|YUCEL"	"naam gemachtigde -JS"
"|DANKER"	"naam gemachtigde -JS"
"|LEWIS"	"naam gemachtigde/veelvoorkomende achternaam- JS"
"|AKTAR"	"naam getuige, komt 1 keer voor op rechtspraak. Geen verwijzing naar de EHRM uitspraak gevonden -JS"
"|SUMER"	"naam griffier"
"|USLU"	"naam griffier - JS"
"|LAHR"	"naam griffier - JS"
"|ADAMSON"	"naam griffier - JS"
"|ALLAOUI"	"naam griffier - JS"
"|KALAC"	"naam griffier - JS"
"|VOGT"	"naam griffier - JS"
"|BRUCKNER"	"naam griffier - JS"
"|AKABBOUZ"	"naam griffier - JS"
"|HODGSON"	"naam griffier - JS"
"|SUTER"	"naam griffier - JS"
"|DORUK"	"naam griffier - JS"
"|SZYMANOWSKI"	"naam griffier - JS"
"|SCHLABS"	"naam griffier - JS"
"|STOJAKOVIC"	"naam griffier -JS"
"|AVDIC"	"naam griffier- JS"
"|KUBICZ"	"naam griffier- JS"
"|IOANNOU"	"naam komt 1 keer voor in een ander verband op rechtspraak. Geen verwijzingen naar de EHRM uitspraak gevonden -JS"
"|BORER"	"naam komt 1 keer voor in een ander verband op rechtspraak. Geen verwijzingen naar de EHRM uitspraak gevonden -JS"
"|RADIC"	"naam komt in ander verband voor - JS"
"|DONAT"	"naam komt in ander verband voor - JS"
"|DANKO"	"naam komt in ander verband voor - JS"
"|BEVERLEY"	"naam komt in ander verband voor - JS"
"|ENDRE"	"naam komt in ander verband voor - JS"
"|ROSIAK"	"naam komt in ander verband voor - JS"
"|GROSSMAN"	"naam komt in ander verband voor - JS"
"|MECH"	"naam komt in ander verband voor - JS"
"|KOKSAL"	"naam komt in ander verband voor op rechtspraak - JS"
"|ALKES"	"naam komt in ander verband voor op rechtspraak - JS"
"|GUL"	"naam komt in ander verband voor op rechtspraak - JS"
"|CAKIR"	"naam komt in ander verband voor op rechtspraak - JS"
"|DE CAROLIS"	"naam komt in een ander verband voor - JS"
"|MASLAK"	"naam komt in een ander verband voor - JS"
"|EL KHOURY"	"naam komt in een ander verband voor - JS"
"|CONSTANTIN"	"naam komt in een ander verband voor - JS"
"|TOTH"	"naam komt in een ander verband voor - JS"
"|SALIN"	"naam komt in een ander verband voor - JS"
"|DE CATERINA"	"naam komt in een ander verband voor - JS"
"|KEMPE"	"naam komt in een ander verband voor - JS"
"|POPA"	"naam komt in een ander verband voor - JS"
"|BORISOV"	"naam komt in een ander verband voor - JS"
"|NICOLA"	"naam komt in een ander verband voor - JS"
"|CAGLAR"	"naam komt in een ander verband voor - JS"
"|GANEA"	"naam komt in een ander verband voor - JS"
"|LEPPER"	"naam komt in een ander verband voor - JS"
"|ADIO"	"naam komt in een ander verband voor - JS"
"|VALMA"	"naam komt in een ander verband voor - JS"
"|KABA"	"naam komt in een ander verband voor - JS"
"|SOARE"	"naam komt in een ander verband voor - JS"
"|YASA"	"naam komt in een ander verband voor - JS"
"|KARAKUS"	"naam komt in een ander verband voor - JS"
"|AKEL"	"naam komt in een ander verband voor - JS"
"|VALENTIN"	"naam komt in een ander verband voor - JS"
"|CORBET"	"naam komt in een ander verband voor - JS"
"|CANAN"	"naam komt in een ander verband voor - JS"
"|BOKE"	"naam komt in een ander verband voor - JS"
"|ROD"	"naam komt in een ander verband voor - JS"
"|TAYLOR"	"naam komt in een ander verband voor - JS"
"|O'BRIEN"	"naam komt in een ander verband voor - JS"
"|DE PACE"	"naam komt in een ander verband voor - JS"
"|CONSTANCIA"	"naam komt in een ander verband voor - JS"
"|McHUGH"	"naam komt in een ander verband voor - JS"
"|ILIEVA"	"naam komt in een ander verband voor - JS"
"|BAHAR"	"naam komt in een ander verband voor - JS"
"|BALABAN"	"naam komt in een ander verband voor - JS"
"|GODFREY"	"naam komt in een ander verband voor - JS"
"|WILLIAMSON"	"naam komt in een ander verband voor - JS"
"|HERON"	"naam komt in een ander verband voor - JS"
"|WALSH"	"naam komt in een ander verband voor - JS"
"|CLAPHAM"	"naam komt in een ander verband voor - JS"
"|TASE"	"naam komt in een ander verband voor - JS"
"|TASKIN"	"naam komt in een ander verband voor - JS"
"|KASA"	"naam komt in een ander verband voor - JS"
"|ORR"	"naam komt in een ander verband voor - JS"
"|ENKE"	"naam komt in een ander verband voor - JS"
"|CATALINA"	"naam komt in een ander verband voor - JS"
"|KEMP"	"naam komt in een ander verband voor - JS"
"|STEVENSON"	"naam komt in een ander verband voor - JS"
"|SEVERIN"	"naam komt in een ander verband voor - JS"
"|GAGA"	"naam komt in een ander verband voor - JS"
"|GARDNER"	"naam komt in een ander verband voor - JS"
"|DIXON"	"naam komt in een ander verband voor - JS"
"|PERSSON"	"naam komt in een ander verband voor - JS"
"|CAMPBELL"	"naam komt in een ander verband voor - JS"
"|YILDIRIM"	"naam komt in een ander verband voor - JS"
"|HATTEN"	"naam komt in een ander verband voor - JS"
"|BULBUL"	"naam komt in een ander verband voor - JS"
"|PIGGOTT"	"naam komt in een ander verband voor - JS"
"|CARROLL"	"naam komt in een ander verband voor - JS"
"|LOFTUS"	"naam komt in een ander verband voor - JS"
"|KOLMAN"	"naam komt in een ander verband voor - JS"
"|PORTER"	"naam komt in een ander verband voor - JS"
"|BRAGA"	"naam komt in een ander verband voor - JS"
"|LUKAC"	"naam komt in een ander verband voor - JS"
"|GLASER"	"naam komt in een ander verband voor - JS"
"|FARA"	"naam komt in een ander verband voor - JS"
"|TARIK"	"naam komt in een ander verband voor - JS"
"|BALAN"	"naam komt in een ander verband voor - JS"
"|UYSAL"	"naam komt in een ander verband voor - JS"
"|MAREK"	"naam komt in een ander verband voor - JS"
"|RADA"	"naam komt in een ander verband voor - JS"
"|RADI"	"naam komt in een ander verband voor - JS"
"|BILICI"	"naam komt in een ander verband voor - JS"
"|CENGIZ"	"naam komt in een ander verband voor - JS"
"|LIBERMAN"	"naam komt in een ander verband voor - JS"
"|DURIC"	"naam komt in een ander verband voor - JS"
"|SAVA"	"naam komt in een ander verband voor - JS"
"|MAHAMMAD"	"naam komt in een ander verband voor - JS"
"|JOHANSSON"	"naam komt in een ander verband voor - JS"
"|ERCAN"	"naam komt in een ander verband voor - JS"
"|WIESER"	"naam komt in een ander verband voor - JS"
"|TARDI"	"naam komt in een ander verband voor - JS"
"|SAOUD"	"naam komt in een ander verband voor - JS"
"|CAPONE"	"naam komt in een ander verband voor - JS"
"|MARINKO"	"naam komt in een ander verband voor - JS"
"|HILTI"	"naam komt in een ander verband voor - JS"
"|SUER"	"naam komt in een ander verband voor - JS"
"|REINER"	"naam komt in een ander verband voor - JS"
"|YANG"	"naam komt in een ander verband voor - JS"
"|KARAN"	"naam komt in een ander verband voor - JS"
"|BUSSMANN"	"naam komt in een ander verband voor - JS"
"|SOURI"	"naam komt in een ander verband voor - JS"
"|PARKES"	"naam komt in een ander verband voor - JS"
"|ELENA"	"naam komt in een ander verband voor - JS"
"|KURNAZ"	"naam komt in een ander verband voor - JS"
"|GUZEL"	"naam komt in een ander verband voor - JS"
"|MASON"	"naam komt in een ander verband voor - JS"
"|MARTI"	"naam komt in een ander verband voor - JS"
"|DILEK"	"naam komt in een ander verband voor - JS"
"|TESTA"	"naam komt in een ander verband voor - JS"
"|HAULER"	"naam komt in een ander verband voor - JS"
"|NANNING"	"naam komt in een ander verband voor - JS"
"|GORIN"	"naam komt in een ander verband voor - JS"
"|LOCATELLI"	"naam komt in een ander verband voor - JS"
"|KAPAN"	"naam komt in een ander verband voor - JS"
"|BELGE"	"naam komt in een ander verband voor - JS"
"|WALDER"	"naam komt in een ander verband voor - JS"
"|LUKASHENKO"	"naam komt in een ander verband voor - JS"
"|DIKA"	"naam komt in een ander verband voor - JS"
"|MCELROY"	"naam komt in een ander verband voor - JS"
"|BILEN"	"naam komt in een ander verband voor - JS"
"|BEHRAMI"	"naam komt in een ander verband voor - JS"
"|HOFBAUER"	"naam komt in een ander verband voor - JS"
"|HOMANN"	"naam komt in een ander verband voor - JS"
"|GULSEN"	"naam komt in een ander verband voor - JS"
"|SECKIN"	"naam komt in een ander verband voor - JS"
"|DURSUN"	"naam komt in een ander verband voor - JS"
"|EVANS"	"naam komt in een ander verband voor - JS"
"|SYLLA"	"naam komt in een ander verband voor - JS"
"|ECKARDT"	"naam komt in een ander verband voor - JS"
"|KARUNA"	"naam komt in een ander verband voor - JS"
"|HANCOCK"	"naam komt in een ander verband voor - JS"
"|GUNGOR"	"naam komt in een ander verband voor - JS"
"|YURT"	"naam komt in een ander verband voor - JS"
"|ZAYED"	"naam komt in een ander verband voor - JS"
"|SVARC"	"naam komt in een ander verband voor - JS"
"|MAC DONALD"	"naam komt in een ander verband voor - JS"
"|PETRIE"	"naam komt in een ander verband voor - JS"
"|HENDERSON"	"naam komt in een ander verband voor - JS"
"|FARHI"	"naam komt in een ander verband voor - JS"
"|SOLMAZ"	"naam komt in een ander verband voor - JS"
"|KONDU"	"naam komt in een ander verband voor - JS"
"|AUGUSTO"	"naam komt in een ander verband voor - JS"
"|SILKA"	"naam komt in een ander verband voor - JS"
"|HERBST"	"naam komt in een ander verband voor - JS"
"|AUBERT"	"naam komt in een ander verband voor - JS"
"|SITO"	"naam komt in een ander verband voor - JS"
"|KOZMA"	"naam komt in een ander verband voor - JS"
"|TURKMEN"	"naam komt in een ander verband voor - JS"
"|FILIP"	"naam komt in een ander verband voor - JS"
"|DAHLBERG"	"naam komt in een ander verband voor - JS"
"|TUNCER"	"naam komt in een ander verband voor - JS"
"|ANTER"	"naam komt in een ander verband voor - JS"
"|IULIANO"	"naam komt in een ander verband voor - JS"
"|HRISTOVA"	"naam komt in een ander verband voor - JS"
"|YAZICI"	"naam komt in een ander verband voor - JS"
"|KORDA"	"naam komt in een ander verband voor - JS"
"|LEEMPOEL"	"naam komt in een ander verband voor - JS"
"|JELICIC"	"naam komt in een ander verband voor - JS"
"|BABA"	"naam komt in een ander verband voor - JS"
"|OKTEM"	"naam komt in een ander verband voor - JS"
"|PAVLOU"	"naam komt in een ander verband voor - JS"
"|ATKINSON"	"naam komt in een ander verband voor - JS"
"|NALBANT"	"naam komt in een ander verband voor - JS"
"|KIR"	"naam komt in een ander verband voor - JS"
"|GUBLER"	"naam komt in een ander verband voor - JS"
"|KLEMENT"	"naam komt in een ander verband voor - JS"
"|KAJA"	"naam komt in een ander verband voor - JS"
"|IMREK"	"naam komt in een ander verband voor - JS"
"|BELLINGER"	"naam komt in een ander verband voor - JS"
"|BURKE"	"naam komt in een ander verband voor - JS"
"|BOZIC"	"naam komt in een ander verband voor - JS"
"|ARSENIC"	"naam komt in een ander verband voor - JS"
"|AVCI"	"naam komt in een ander verband voor - JS"
"|ORS"	"naam komt in een ander verband voor - JS"
"|TAIS"	"naam komt in een ander verband voor - JS"
"|SECHIN"	"naam komt in een ander verband voor - JS"
"|BERTIN"	"naam komt in een ander verband voor - JS"
"|GEORGI"	"naam komt in een ander verband voor - JS"
"|McBRIDE"	"naam komt in een ander verband voor - JS"
"|PROSSER"	"naam komt in een ander verband voor - JS"
"|DAMMANN"	"naam komt in een ander verband voor - JS"
"|CASSE"	"naam komt in een ander verband voor - JS"
"|DE LUCA"	"naam komt in een ander verband voor - JS"
"|DENU"	"naam komt in een ander verband voor - JS"
"|SONER"	"naam komt in een ander verband voor - JS"
"|ATAMAN"	"naam komt in een ander verband voor - JS"
"|FONDA"	"naam komt in een ander verband voor - JS"
"|CARTA"	"naam komt in een ander verband voor - JS"
"|KRISTOF"	"naam komt in een ander verband voor - JS"
"|KELLER"	"naam komt in een ander verband voor - JS"
"|HAFNER"	"naam komt in een ander verband voor - JS"
"|JAWORSKI"	"naam komt in een ander verband voor - JS"
"|KUR"	"naam komt in een ander verband voor - JS"
"|MELLO"	"naam komt in een ander verband voor - JS"
"|DURMAZ"	"naam komt in een ander verband voor - JS"
"|RITCHIE"	"naam komt in een ander verband voor - JS"
"|STAUDER"	"naam komt in een ander verband voor - JS"
"|DILLON"	"naam komt in een ander verband voor - JS"
"|AKIN"	"naam komt in een ander verband voor - JS"
"|DREU"	"naam komt in een ander verband voor - JS"
"|PILLA"	"naam komt in een ander verband voor - JS"
"|MEMIS"	"naam komt in een ander verband voor - JS"
"|MELCHIOR"	"naam komt in een ander verband voor - JS"
"|OZSOY"	"naam komt in een ander verband voor - JS"
"|MIZZI"	"naam komt in een ander verband voor - JS"
"|YAZAR"	"naam komt in een ander verband voor - JS"
"|BUDAK"	"naam komt in een ander verband voor - JS"
"|RIST"	"naam komt in een ander verband voor - JS"
"|WISSE"	"naam komt in een ander verband voor - JS"
"|THON"	"naam komt in een ander verband voor - JS"
"|KABAT"	"naam komt in een ander verband voor - JS"
"|CAPKOVA"	"naam komt in een ander verband voor - JS"
"|KANTOR"	"naam komt in een ander verband voor - JS"
"|GEZICI"	"naam komt in een ander verband voor - JS"
"|ALVER"	"naam komt in een ander verband voor - JS"
"|MARIEN"	"naam komt in een ander verband voor - JS"
"|ESER"	"naam komt in een ander verband voor - JS"
"|MATHEW"	"naam komt in een ander verband voor - JS"
"|KOMAN"	"naam komt in een ander verband voor - JS"
"|FRIK"	"naam komt in een ander verband voor - JS"
"|LEVEAU"	"naam komt in een ander verband voor - JS"
"|TEMEL"	"naam komt in een ander verband voor - JS"
"|ZAFIROPOULOS"	"naam komt in een ander verband voor - JS"
"|VAN OFFEREN"	"naam komt in een ander verband voor - JS"
"|ARVANITIS"	"naam komt in een ander verband voor - JS"
"|OCALAN"	"naam komt in een ander verband voor - JS"
"|CLAES"	"naam komt in een ander verband voor - JS"
"|GULTEKIN"	"naam komt in een ander verband voor - JS"
"|CALI"	"naam komt in een ander verband voor - JS"
"|KORRE"	"naam komt in een ander verband voor - JS"
"|WHITFIELD"	"naam komt in een ander verband voor - JS"
"|RAINYS"	"naam komt in een ander verband voor - JS"
"|ERTURK"	"naam komt in een ander verband voor - JS"
"|MARIANI"	"naam komt in een ander verband voor - JS"
"|MATHEUS"	"naam komt in een ander verband voor - JS"
"|HARAP"	"naam komt in een ander verband voor - JS"
"|PEYAM"	"naam komt in een ander verband voor - JS"
"|AHMADOV"	"naam komt in een ander verband voor - JS"
"|LOY"	"naam komt in een ander verband voor - JS"
"|SISAK"	"naam komt in een ander verband voor - JS"
"|KOKKINI"	"naam komt in een ander verband voor - JS"
"|GOLA"	"naam komt in een ander verband voor - JS"
"|UHL"	"naam komt in een ander verband voor - JS"
"|THALER"	"naam komt in een ander verband voor - JS"
"|OZDOGAN"	"naam komt in een ander verband voor - JS"
"|TOWNSEND"	"naam komt in een ander verband voor - JS"
"|HALIS"	"naam komt in een ander verband voor - JS"
"|RASH"	"naam komt in een ander verband voor - JS"
"|KILIAN"	"naam komt in een ander verband voor - JS"
"|ELDEN"	"naam komt in een ander verband voor - JS"
"|VRANA"	"naam komt in een ander verband voor - JS"
"|NORWOOD"	"naam komt in een ander verband voor - JS"
"|SPENCE"	"naam komt in een ander verband voor - JS"
"|GLOVER"	"naam komt in een ander verband voor - JS"
"|FABRE"	"naam komt in een ander verband voor - JS"
"|UNAL"	"naam komt in een ander verband voor - JS"
"|KALIN"	"naam komt in een ander verband voor - JS"
"|CARLETTI"	"naam komt in een ander verband voor - JS"
"|MARASLI"	"naam komt in een ander verband voor - JS"
"|ULLRICH"	"naam komt in een ander verband voor - JS"
"|FIDAN"	"naam komt in een ander verband voor - JS"
"|BEALE"	"naam komt in een ander verband voor - JS"
"|MOLNAR"	"naam komt in een ander verband voor - JS"
"|LOISEAU"	"naam komt in een ander verband voor - JS"
"|AGATHOS"	"naam komt in een ander verband voor - JS"
"|NEWBY"	"naam komt in een ander verband voor - JS"
"|JANAS"	"naam komt in een ander verband voor - JS"
"|BELAN"	"naam komt in een ander verband voor - JS"
"|ERKEK"	"naam komt in een ander verband voor - JS"
"|MONTI"	"naam komt in een ander verband voor - JS"
"|MACHNIK"	"naam komt in een ander verband voor - JS"
"|RINGEL"	"naam komt in een ander verband voor - JS"
"|MONTANARI"	"naam komt in een ander verband voor - JS"
"|KRANZ"	"naam komt in een ander verband voor - JS"
"|ALGE"	"naam komt in een ander verband voor - JS"
"|DAVENPORT"	"naam komt in een ander verband voor - JS"
"|LORSE"	"naam komt in een ander verband voor - JS"
"|MEHO"	"naam komt in een ander verband voor - JS"
"|CRONIN"	"naam komt in een ander verband voor - JS"
"|PENA"	"naam komt in een ander verband voor - JS"
"|FAIVRE"	"naam komt in een ander verband voor - JS"
"|KULTER"	"naam komt in een ander verband voor - JS"
"|HUART"	"naam komt in een ander verband voor - JS"
"|PLATON"	"naam komt in een ander verband voor - JS"
"|HORTICULTURAL"	"naam komt in een ander verband voor - JS"
"|FINDLATER"	"naam komt in een ander verband voor - JS"
"|CASTILLON"	"naam komt in een ander verband voor - JS"
"|BOUDIER"	"naam komt in een ander verband voor - JS"
"|EGAN"	"naam komt in een ander verband voor - JS"
"|HASHMAN"	"naam komt in een ander verband voor - JS"
"|SERIF"	"naam komt in een ander verband voor - JS"
"|ANGELI"	"naam komt in een ander verband voor - JS"
"|SCHOBER"	"naam komt in een ander verband voor - JS"
"|VEGH"	"naam komt in een ander verband voor - JS"
"|BERKVENS"	"naam komt in een ander verband voor - JS"
"|GRUNFELD"	"naam komt in een ander verband voor - JS"
"|AINSWORTH"	"naam komt in een ander verband voor - JS"
"|BYRNE"	"naam komt in een ander verband voor - JS"
"|BOYD"	"naam komt in een ander verband voor - JS"
"|MOHAMMAD"	"naam komt in een ander verband voor - JS"
"|WILHELM"	"naam komt in een ander verband voor - JS"
"|FERRARA"	"naam komt in een ander verband voor - JS"
"|FIDLER"	"naam komt in een ander verband voor - JS"
"|GARLAND"	"naam komt in een ander verband voor - JS"
"|KELLING"	"naam komt in een ander verband voor - JS"
"|SIMMER"	"naam komt in een ander verband voor - JS"
"|McLEOD"	"naam komt in een ander verband voor - JS"
"|GUERIN"	"naam komt in een ander verband voor - JS"
"|CASAGRANDE"	"naam komt in een ander verband voor - JS"
"|FLEISCHHACKER"	"naam komt in een ander verband voor - JS"
"|JOHAL"	"naam komt in een ander verband voor - JS"
"|SCHOPFER"	"naam komt in een ander verband voor - JS"
"|REINHARDT"	"naam komt in een ander verband voor - JS"
"|HOZEE"	"naam komt in een ander verband voor - JS"
"|BERTELLI"	"naam komt in een ander verband voor - JS"
"|VESTERBY"	"naam komt in een ander verband voor - JS"
"|GUERRA"	"naam komt in een ander verband voor - JS"
"|KOPP"	"naam komt in een ander verband voor - JS"
"|BOTTA"	"naam komt in een ander verband voor - JS"
"|RIAZ"	"naam komt in een ander verband voor - JS"
"|RAJA"	"naam komt in een ander verband voor - JS"
"|VAN DEN MAAGDENBERG"	"naam komt in een ander verband voor - JS"
"|BAHADDAR"	"naam komt in een ander verband voor - JS"
"|GEDIN"	"naam komt in een ander verband voor - JS"
"|BERGLUND"	"naam komt in een ander verband voor - JS"
"|METAXA"	"naam komt in een ander verband voor - JS"
"|LEDGER"	"naam komt in een ander verband voor - JS"
"|MALLARD"	"naam komt in een ander verband voor - JS"
"|FUKS"	"naam komt in een ander verband voor - JS"
"|TANGE"	"naam komt in een ander verband voor - JS"
"|TORRI"	"naam komt in een ander verband voor - JS"
"|HALFORD"	"naam komt in een ander verband voor - JS"
"|GRATZER"	"naam komt in een ander verband voor - JS"
"|BELLIS"	"naam komt in een ander verband voor - JS"
"|FOUCHER"	"naam komt in een ander verband voor - JS"
"|BEGUM"	"naam komt in een ander verband voor - JS"
"|ASLAM"	"naam komt in een ander verband voor - JS"
"|KINGSTON"	"naam komt in een ander verband voor - JS"
"|CARTLEDGE"	"naam komt in een ander verband voor - JS"
"|WIEDEMANN"	"naam komt in een ander verband voor - JS"
"|MISSON"	"naam komt in een ander verband voor - JS"
"|HAUPTMANN"	"naam komt in een ander verband voor - JS"
"|EUGENIA"	"naam komt in een ander verband voor - JS"
"|TOUVIER"	"naam komt in een ander verband voor - JS"
"|KUMAR"	"naam komt in een ander verband voor - JS"
"|FORDE"	"naam komt in een ander verband voor - JS"
"|BLUMENTHAL"	"naam komt in een ander verband voor - JS"
"|KANAN"	"naam komt in een ander verband voor - JS"
"|DOBBIE"	"naam komt in een ander verband voor - JS"
"|PULLAR"	"naam komt in een ander verband voor - JS"
"|ELLIES"	"naam komt in een ander verband voor - JS"
"|FRESE"	"naam komt in een ander verband voor - JS"
"|CONNOLLY"	"naam komt in een ander verband voor - JS"
"|BAXTER"	"naam komt in een ander verband voor - JS"
"|WELCH"	"naam komt in een ander verband voor - JS"
"|MORTENSEN"	"naam komt in een ander verband voor - JS"
"|KELMAN"	"naam komt in een ander verband voor - JS"
"|POKU"	"naam komt in een ander verband voor - JS"
"|CHOUDRY"	"naam komt in een ander verband voor - JS"
"|BENZE"	"naam komt in een ander verband voor - JS"
"|JOHNSTON"	"naam komt in een ander verband voor - JS"
"|PRATT"	"naam komt in een ander verband voor - JS"
"|VAN DER PEET"	"naam komt in een ander verband voor - JS"
"|STIFTER"	"naam komt in een ander verband voor - JS"
"|BELLET"	"naam komt in een ander verband voor - JS"
"|BECHER"	"naam komt in een ander verband voor - JS"
"|NORDLING"	"naam komt in een ander verband voor - JS"
"|FEINGOLD"	"naam komt in een ander verband voor - JS"
"|SCOLLO"	"naam komt in een ander verband voor - JS"
"|OLLE"	"naam komt in een ander verband voor - JS"
"|BROCK"	"naam komt in een ander verband voor - JS"
"|BATES"	"naam komt in een ander verband voor - JS"
"|ARRABAL"	"naam komt in een ander verband voor - JS"
"|BAEGEN"	"naam komt in een ander verband voor - JS"
"|POTTS"	"naam komt in een ander verband voor - JS"
"|PETROU"	"naam komt in een ander verband voor - JS"
"|DUSHI"	"naam komt in een ander verband voor - JS"
"|BACHMANN"	"naam komt in een ander verband voor - JS"
"|SIMONIAN"	"naam komt in een ander verband voor - JS"
"|MANSUR"	"naam komt in een ander verband voor - JS"
"|KORNER"	"naam komt in een ander verband voor - JS"
"|KANDEL"	"naam komt in een ander verband voor - JS"
"|HAGELE"	"naam komt in een ander verband voor - JS"
"|BERECZKI"	"naam komt in een ander verband voor - JS"
"|FRANKEL"	"naam komt in een ander verband voor - JS"
"|TRAVERS"	"naam komt in een ander verband voor - JS"
"|MAIKOE"	"naam komt in een ander verband voor - JS"
"|KOFLER"	"naam komt in een ander verband voor - JS"
"|RASSY"	"naam komt in een ander verband voor - JS"
"|KAMARA"	"naam komt in een ander verband voor - JS"
"|SENN"	"naam komt in een ander verband voor - JS"
"|VERMEIRE"	"naam komt in een ander verband voor - JS"
"|INSAM"	"naam komt in een ander verband voor - JS"
"|LIEFVELD"	"naam komt in een ander verband voor - JS"
"|BRANDNER"	"naam komt in een ander verband voor - JS"
"|ISAACS"	"naam komt in een ander verband voor - JS"
"|KILYEN"	"naam komt in een ander verband voor - JS"
"|B. COMPANY"	"naam komt in een ander verband voor - JS"
"|SCHWABE"	"naam komt in een ander verband voor - JS"
"|BYRN"	"naam komt in een ander verband voor - JS"
"|LOCKWOOD"	"naam komt in een ander verband voor - JS"
"|MARGARETA"	"naam komt in een ander verband voor - JS"
"|GANA"	"naam komt in een ander verband voor - JS"
"|OBSERVER"	"naam komt in een ander verband voor - JS"
"|HAYWARD"	"naam komt in een ander verband voor - JS"
"|ASCH"	"naam komt in een ander verband voor - JS"
"|VAN KUYK"	"naam komt in een ander verband voor - JS"
"|MORI"	"naam komt in een ander verband voor - JS"
"|MATTSSON"	"naam komt in een ander verband voor - JS"
"|KJELLBERG"	"naam komt in een ander verband voor - JS"
"|McGOVERN"	"naam komt in een ander verband voor - JS"
"|HAYE"	"naam komt in een ander verband voor - JS"
"|BYLOOS"	"naam komt in een ander verband voor - JS"
"|SMIET"	"naam komt in een ander verband voor - JS"
"|RADERMACHER"	"naam komt in een ander verband voor - JS"
"|KRAFFT"	"naam komt in een ander verband voor - JS"
"|LEHMANN"	"naam komt in een ander verband voor - JS"
"|CHAPPELL"	"naam komt in een ander verband voor - JS"
"|SARGIN"	"naam komt in een ander verband voor - JS"
"|HAHNE"	"naam komt in een ander verband voor - JS"
"|BANER"	"naam komt in een ander verband voor - JS"
"|DUGGAN"	"naam komt in een ander verband voor - JS"
"|SCHRAFT"	"naam komt in een ander verband voor - JS"
"|KEIJSPER"	"naam komt in een ander verband voor - JS"
"|NISSEN"	"naam komt in een ander verband voor - JS"
"|JARMAN"	"naam komt in een ander verband voor - JS"
"|SAMS"	"naam komt in een ander verband voor - JS"
"|RUPP"	"naam komt in een ander verband voor - JS"
"|MIKELSONS"	"naam komt in een ander verband voor - JS"
"|PEYER"	"naam komt in een ander verband voor - JS"
"|NEUMEISTER"	"naam komt in een ander verband voor - JS"
"|BAADER"	"naam komt in een ander verband voor - JS"
"|KAMMA"	"naam komt in een ander verband voor - JS"
"|DE BECKER"	"naam komt in een ander verband voor - JS"
"|LAWLESS"	"naam komt in een ander verband voor - JS"
"|GELAUDE"	"naam komt in een ander verband voor - JS"
"|PLAISIER"	"naam komt in een ander verband voor - JS"
"|LANKESTER"	"naam komt in een ander verband voor - JS"
"|HAALMEIJER"	"naam komt in een ander verband voor - JS"
"|WINTERSTEIN"	"naam komt in een ander verband voor - JS"
"|KONSTANTINOU"	"naam komt in een ander verband voor - JS"
"|NABIL"	"naam komt in een ander verband voor - JS"
"|SARAR"	"naam komt in een ander verband voor - JS"
"|ALMAZ"	"naam komt in een ander verband voor - JS"
"|STANA"	"naam komt in een ander verband voor - JS"
"|SCHNEEWEISS"	"naam komt in een ander verband voor - JS"
"|ABDULRAHMAN"	"naam komt in een ander verband voor - JS"
"|KUBES"	"naam komt in een ander verband voor - JS"
"|ILIE"	"naam komt in een ander verband voor - JS"
"|BUCUR"	"naam komt in een ander verband voor - JS"
"|EFE"	"naam komt in een ander verband voor - JS"
"|GASSNER"	"naam komt in een ander verband voor - JS"
"|BANU"	"naam komt in een ander verband voor - JS"
"|MICHAUD"	"naam komt in een ander verband voor - JS"
"|BUTT"	"naam komt in een ander verband voor - JS"
"|STEPIEN"	"naam komt in een ander verband voor - JS"
"|STRUC"	"naam komt in een ander verband voor - JS"
"|MENGI"	"naam komt in een ander verband voor - JS"
"|JOOS"	"naam komt in een ander verband voor - JS"
"|ERDAL"	"naam komt in een ander verband voor - JS"
"|KURA"	"naam komt in een ander verband voor - JS"
"|OZAN"	"naam komt in een ander verband voor - JS"
"|PANUS"	"naam komt in een ander verband voor - JS"
"|KAYAK"	"naam komt in een ander verband voor - JS"
"|TENE"	"naam komt in een ander verband voor - JS"
"|ALKAN"	"naam komt in een ander verband voor - JS"
"|COLON"	"naam komt in een ander verband voor - JS"
"|TURKER"	"naam komt in een ander verband voor - JS"
"|VYDRIN"	"naam komt in een ander verband voor - JS"
"|VUK"	"naam komt in een ander verband voor - JS"
"|NICOARA"	"naam komt in een ander verband voor - JS"
"|MAJURI"	"naam komt in een ander verband voor - JS"
"|ARDA"	"naam komt in een ander verband voor - JS"
"|TUZ"	"naam komt in een ander verband voor - JS"
"|BASER"	"naam komt in een ander verband voor - JS"
"|MITROKHIN"	"naam komt in een ander verband voor - JS"
"|FIDANCI"	"naam komt in een ander verband voor - JS"
"|KILICASLAN"	"naam komt in een ander verband voor - JS"
"|JUSUF"	"naam komt in een ander verband voor - JS"
"|NEMES"	"naam komt in een ander verband voor - JS"
"|MATI"	"naam komt in een ander verband voor - JS"
"|HUET"	"naam komt in een ander verband voor - JS"
"|POIROT"	"naam komt in een ander verband voor - JS"
"|YANIK"	"naam komt in een ander verband voor - JS"
"|KALKAN"	"naam komt in een ander verband voor - JS"
"|TRANSPETROL"	"naam komt in een ander verband voor - JS"
"|DE SIMONE"	"naam komt in een ander verband voor - JS"
"|STASI"	"naam komt in een ander verband voor - JS"
"|GIUSTI"	"naam komt in een ander verband voor - JS"
"|BOSTANCI"	"naam komt in een ander verband voor - JS"
"|SURY"	"naam komt in een ander verband voor - JS"
"|NEVSKAYA"	"naam komt in een ander verband voor - JS"
"|ERCIYAS"	"naam komt in een ander verband voor - JS"
"|ZUPAN"	"naam komt in een ander verband voor - JS"
"|YUN"	"naam komt in een ander verband voor - JS"
"|WILKES"	"naam komt in een ander verband voor - JS"
"|WYSOCKI"	"naam komt in een ander verband voor - JS"
"|CAKAR"	"naam komt in een ander verband voor -JS"
"|BROCHU"	"naam komt in een ander verband voor -JS"
"|DRIEMAN"	"naam komt in een ander verband voor -JS"
"|FITT"	"naam komt in een ander verband voor -JS"
"|ALDO"	"naam komt in een ander verband voor -JS"
"|CONDE"	"naam komt in een ander verband voor -JS"
"|SALVATORI"	"naam komt in een ander verband voor -JS"
"|HALIL"	"naam komt in een ander verband voor -JS"
"|PERKS"	"naam komt in een ander verband voor -JS"
"|DUNN"	"naam komt in een ander verband voor -JS"
"|DRUMMOND"	"naam komt in een ander verband voor -JS"
"|LEANDER"	"naam komt in een ander verband voor -JS"
"|RYDSTROM"	"naam komt in een ander verband voor -JS"
"|MUNRO"	"naam komt in een ander verband voor -JS"
"|GILLARD"	"naam komt in een ander verband voor -JS"
"|KALEMA"	"naam komt in een ander verband voor -JS"
"|BRANT"	"naam komt in een ander verband voor -JS"
"|COMPANY S."	"naam komt in een ander verband voor -JS"
"|KAUFMAN"	"naam komt in een ander verband voor -JS"
"|BENTHEM"	"naam komt in een ander verband voor -JS"
"|JOLIE"	"naam komt in een ander verband voor -JS"
"|LINDE"	"naam komt in een ander verband voor -JS"
"|LANT"	"naam komt in een ander verband voor -JS"
"|SEALE"	"naam komt in een ander verband voor -JS"
"|SLADE"	"naam komt in een ander verband voor -JS"
"|PETTY"	"naam komt in een ander verband voor -JS"
"|A. ASSOCIATION"	"naam komt in een ander verband voor -JS"
"|C. Family"	"naam komt in een ander verband voor -JS"
"|LE COMPTE"	"naam komt in een ander verband voor -JS"
"|A. Union"	"naam komt in een ander verband voor -JS"
"|ADOLF"	"naam komt in een ander verband voor -JS"
"|BLIC"	"naam komt in een ander verband voor -JS"
"|VASQUEZ"	"naam komt in een ander verband voor -JS"
"|CHAUDHRY"	"naam komt in een ander verband voor -JS"
"|DARA"	"naam komt in een ander verband voor -JS"
"|KOZIOL"	"naam komt in een ander verband voor -JS"
"|GOREN"	"naam komt in een ander verband voor -JS"
"|HOSSA"	"naam komt in een ander verband voor -JS"
"|KONAK"	"naam komt in een ander verband voor -JS"
"|BARTOK"	"naam komt in een ander verband voor -JS"
"|PIETA"	"naam komt in een ander verband voor -JS"
"|MILOS"	"naam komt in een ander verband voor -JS"
"|RADEMACHER"	"naam komt in een ander verband voor -JS"
"|GHALI"	"naam komt in een ander verband voor -JS"
"|JALLOW"	"naam komt in een ander verband voor -JS"
"|KHALIL"	"naam komt in een ander verband voor -JS"
"|BOGDAN"	"naam komt in een ander verband voor op rechtspraak - JS"
"|ALICI"	"naam komt in een ander verband voor op rechtspraak - JS"
"|VODA"	"naam komt in een ander verband voor op rechtspraak - JS"
"|BISTA"	"naam komt in een ander verband voor op rechtspraak - JS"
"|AKKUS"	"naam komt in een ander verband voor op rechtspraak - JS"
"|ALVES"	"naam komt in een ander verband voor op rechtspraak - JS"
"|FRANCOIS"	"naam komt in een ander verband voor op rechtspraak - JS"
"|MINKO"	"naam komt voor in citaat -JS"
"|HOLLY"	"naam komt voor in een ander verband -JS"
"|VALERIU"	"naam komt voor in een ander verband -JS"
"|BAKA"	"naam komt voor in een ander verband -JS"
"|DURIC"	"naam komt voor in een ander verband -JS"
"|MESIC"	"naam komt voor in een ander verband -JS"
"|BILGIN"	"naam komt voor in een ander verband -JS"
"|IPEK"	"naam komt voor in een ander verband -JS"
"|BOOTH"	"naam komt voor in een ander verband -JS"
"|BELKIN"	"naam komt voor in een ander verband -JS"
"|DUMAN"	"naam komt voor in een ander verband -JS"
"|ORBAN"	"naam komt voor in een ander verband -JS"
"|ACIK"	"naam komt voor in een ander verband -JS"
"|STANKOVIC"	"naam komt voor in een ander verband -JS"
"|ZEMAN"	"naam komt voor in een ander verband -JS"
"|TANAY"	"naam komt voor in een ander verband -JS"
"|KES"	"naam komt voor in een ander verband -JS"
"|LUKIC"	"naam komt voor in een ander verband -JS"
"|GALKA"	"naam komt voor in een ander verband -JS"
"|BOTA"	"naam komt voor in een ander verband -JS"
"|GUBER"	"naam komt voor in een ander verband -JS"
"|DRAGOMIR"	"naam komt voor in een ander verband -JS"
"|AKIN"	"naam komt voor in een ander verband -JS"
"|FRIEDRICH"	"naam komt voor in een ander verband -JS"
"|HAHN"	"naam komt voor in een ander verband -JS"
"|LATTA"	"naam komt voor in een ander verband -JS"
"|SLACK"	"naam komt voor in een ander verband -JS"
"|PAIS"	"naam krant - JS"
"|HENNIS"	"naam minister - JS"
"|MATZINGER"	"naam notaris - JS"
"|CAMERON"	"naam premier Engeland - JS"
"|BASARAN"	"naam psychiater die enkele malen voorkomt op rechtspraak -JS"
"|FRODL"	"naam psychiater die meerdere malen voorkomt op rechtspraak - JS"
"|DURAN"	"naam psycholoog die voorkomt op rechtspraak - JS"
"|DRAYER"	"naam rechter - JS"
"|DULEK"	"naam rechter - JS"
"|VAN WAEGENINGH"	"naam rechter - JS"
"|LUKACS"	"naam rechter - JS"
"|WURZER"	"naam rechter - JS"
"|ALWIN"	"naam rechter -JS"
"|PURCELL"	"naam rechter -JS"
"|CAPITAN"	"naam schip op rechtspraak - JS"
"|WINKLER"	"naam school - JS"
"|CONE"	"naam school - JS"
"|BEDIR"	"naam school - JS"
"|TABOR"	"naam school - JS"
"|BELLO"	"naam school - JS"
"|ARUC"	"naam school - JS"
"|PONTES"	"naam school - JS"
"|ARENT"	"naam stichting - JS"
"|RAVON"	"naam stichting - JS"
"|WENDE"	"naam stichting - JS"
"|MANDIR"	"naam stichting - JS"
"|LAKA"	"naam stichting - JS"
"|ISKCON"	"naam stichting - JS"
"|SEVA"	"naam stichting - JS"
"|MEZO"	"naam stichting - JS"
"|FUNKE"	"naam terrein in Amsterdam - JS"
"|GURBUZ"	"naam tolk - JS"
"|KAYGISIZ"	"naam tolk - JS"
"|HUSAK"	"naam tolk - JS"
"|RASHED"	"naam tolk - JS"
"|ABRAHAMIAN"	"naam tolk - JS"
"|VOLKOVA"	"naam tolk - JS"
"|KAPAR"	"naam tolk - JS"
"|MUSA"	"naam tolk - JS"
"|NIKOLOPOULOS"	"naam tolk - JS"
"|STOYANOVA"	"naam tolk - JS"
"|AKSAC"	"naam tolk - JS"
"|BELEK"	"naam tolk - JS"
"|HEIDARI"	"naam tolk - JS"
"|SULAR"	"naam tolk - JS"
"|HASHIMI"	"naam tolk - JS"
"|DORDEVIC"	"naam tolk - JS"
"|HASANI"	"naam tolk  op rechtspraak - JS"
"|ARPAT"	"naam tolk die vaak voorkomt op rechtspraak - JS"
"|DONMEZ"	"naam tolk -JS"
"|IZCI"	"naam tolk -JS"
"|ABDI"	"naam tolk -JS"
"|TIRON"	"naam uitgever - JS"
"|EKONOMI"	"Naam Universiteit - JS"
"|DURHAM"	"naam universiteit - JS"
"|WEBSTER"	"naam universiteit - JS"
"|MESZAROS"	"naam van arts -JS"
"|MILANOVIC"	"naam van auteur die meerdere keren voorkomt op rechtspraak -JS"
"|AYTAS"	"naam van een advocaat - JS"
"|AKSOY"	"naam van een arts die vaak voorkomt - JS"
"|RISA"	"naam van een gemeente ambtenaar - JS"
"|MANOVA"	"naam van een HvJ uitspraak (HvJ EU 10 oktober 2013, C-336/12) - JS"
"|ALPHAN"	"naam van een kliniek in Duitsland. Komt eenmaal voor op rechtspraak. Geen verwijzing naar EHRM uitspraak gevonden. - JS"
"|MUR"	"naam van een partij die veelvuldig voorkomt op rechtspraak -JS"
"|FLEURY"	"naam van een Stichting die veelvuldig genoemd wordt op rechtspraak - JS"
"|KUBLER"	"naam van een stichting. Geen verwijzing naar de EHRM uitspraak gevonden."
"|TAMIR"	"naam van een tolk - JS"
"|OKTAS"	"naam van een tolk op rechtspraak - JS"
"|DICLE"	"naam van een universiteit - JS"
"|OVRAN"	"naam van een vereniging. Komt meerdere malen voor op rechtspraak - JS"
"|PHOCAS"	"naam vereniging - JS"
"|SAMADI"	"naam verzekeringsarts - JS"
"|JACOBSSON"	"naam verzekeringsarts die vaak voorkomt op rechtspraak - JS"
"|MARINA"	"naam voor drijvend woonhuis - veelvoorkomend op rechtspraak - JS"
"|PETRIDIS"	"naam wordt in een ander verband gebruikt op rechtspraak -JS"
"|GIRGIS"	"naam wordt in een ander verband gebruikt op rechtspraak -JS"
"|ANTONOV"	"naam wordt in een ander verband gebruikt op rechtspraak -JS"
"|ROHR"	"naam wordt in een ander verband gebruikt op rechtspraak -JS"
"|TROFIM"	"naam wordt in een ander verband gebruikt op rechtspraak -JS"
"|LISS"	"naam wordt in een ander verband gebruikt op rechtspraak -JS"
"|HENNE"	"naam wordt op diverse wijze gebruikt - JS"
"|VATAN"	"naam ziekenhuis - JS"
"|BATI"	"naam ziekenhuis - JS"
"|FLUX"	"natuurkundige term - JS"
"|KRAT"	"Nederlands woord - JS"
"|KLIK"	"Nederlands woord - JS"
"|PUTTER"	"Nederlands woord - JS"
"|GAL"	"Nederlands woord - JS"
"|NIESEN"	"Nederlands woord - JS"
"|DEEG"	"Nederlands woord - JS"
"|PAK"	"Nederlands woord - JS"
"|LEGER"	"Nederlands woord - JS"
"|ENGEL"	"Nederlands woord en veelvuldig voorkomende achternaam -JS"
"|ALLEN"	"Nederlands woord en veelvuldig voorkomende achternaam -JS"
"|MAN"	"Nederlands woord en veelvuldig voorkomende achternaam -JS"
"|KALENDER"	"Nederlands woord- JS"
"|KART"	"Nederlands woord- JS"
"|ZAK"	"Nederlands woord- JS"
"|KOK"	"Nederlands woord- JS"
"|ER"	"Nederlands woord- JS"
"|NA."	"Nederlands woord/afkorting -JS"
"|GORDON"	"Nl artiest/ gangbare voornaam - JS"
"|FERME"	"nl en fr woord - JS"
"|BRANDT"	"NL werkwoord branden - JS"
"|BEKER"	"NL woord - JS"
"|VAAS"	"NL woord - JS"
"|LANG"	"NL woord - JS"
"|KUS"	"NL woord - JS"
"|PARK"	"NL woord - JS"
"|STEEG"	"NL woord - JS"
"|ROMMEL"	"NL woord - JS"
"|PAD"	"NL woord - JS"
"|BADER"	"NL woord - JS"
"|STEEN"	"NL woord - JS"
"|KERN"	"NL woord - JS"
"|SCHENK"	"NL woord - JS"
"|NESTOR"	"NL woord - JS"
"|HART"	"NL woord - JS"
"|ZICH"	"NL woord - JS"
"|TAS"	"nl woord - JS"
"|DAG"	"nl woord - JS"
"|BOT"	"nl woord - JS"
"|BERK"	"nl woord - JS"
"|RAND"	"nl woord - JS"
"|TUT"	"nl woord - JS"
"|KOLK"	"nl woord - JS"
"|TAAL"	"NL woord - JS"
"|HUN"	"NL woord - JS"
"|DAS"	"NL woord - JS"
"|ONDER"	"NL woord - JS"
"|MILD"	"NL woord - JS"
"|VETTER"	"NL woord - JS"
"|REUS"	"NL woord - JS"
"|STOLK"	"NL woord - JS"
"|BEET"	"NL woord - JS"
"|STEEL"	"NL woord - JS"
"|STIFT"	"NL woord - JS"
"|BELLER"	"NL woord - JS"
"|PAUSE"	"NL woord - JS"
"|GROF"	"NL woord - JS"
"|HUTTEN"	"NL woord - JS"
"|TROOST"	"nl woord - JS"
"|GAST"	"nl woord - JS"
"|MOE"	"nl woord - JS"
"|GROS"	"nl woord - JS"
"|SERRE"	"nl woord - JS"
"|PRAK"	"nl woord - JS"
"|POLI"	"nl woord - JS"
"|HEIKEL"	"nl woord - JS"
"|MENS"	"nl woord - JS"
"|DE MAN"	"nl woord - JS"
"|PARTOON"	"nl woord - JS"
"|WORM"	"nl woord - JS"
"|ATLAS"	"nl woord - JS"
"|WINTER"	"nl woord - JS"
"|MANTEL"	"nl woord - JS"
"|LANGER"	"nl woord - JS"
"|BURGER"	"nl woord - JS"
"|BOTTEN"	"nl woord - JS"
"|HUMMELS"	"nl woord - JS"
"|MENG"	"nl woord - JS"
"|SPEER"	"nl woord - JS"
"|KROON"	"nl woord - JS"
"|WILDE"	"nl woord - JS"
"|HOOS"	"nl woord - JS"
"|KRITSCH"	"nl woord - JS"
"|HEDEN"	"nl woord - JS"
"|WACHTMEESTER"	"nl woord - JS"
"|KEUS"	"nl woord - JS"
"|SCHADEN"	"nl woord - JS"
"|SPAANS"	"nl woord - JS"
"|STRAND"	"nl woord - JS"
"|WITTER"	"nl woord - JS"
"|MIN"	"nl woord - JS"
"|REED"	"nl woord - JS"
"|ZAND"	"nl woord - JS"
"|NAGEL"	"nl woord - JS"
"|DINER"	"nl woord - JS"
"|DENK"	"nl woord - JS"
"|SCALA"	"nl woord - JS"
"|VOLK"	"nl woord - JS"
"|SCHILDER"	"nl woord - JS"
"|KNECHT"	"nl woord - JS"
"|KAPEL"	"nl woord - JS"
"|GELD"	"nl woord - JS"
"|BOZE"	"nl woord - JS"
"|ROT"	"nl woord - JS"
"|TOREN"	"nl woord - JS"
"|DE DONDER"	"nl woord - JS"
"|HOUT"	"NL woord -JS"
"|BREDE"	"NL woord -JS"
"|POST"	"NL woord -JS"
"|LOS"	"NL woord -JS"
"|KACHEL"	"NL woord -JS"
"|TOT"	"NL woord -JS"
"|LANGE"	"NL woord -JS"
"|WOLF"	"NL woord -JS"
"|HAMER"	"NL woord -JS"
"|GEEN"	"NL woord -JS"
"|PROMPT"	"NL woord -JS"
"|LOS"	"NL woord -JS"
"|BALEN"	"NL woord -JS"
"|APOSTOL"	"NL woord -JS"
"|AL"	"NL woord -JS"
"|LAM"	"NL woord -JS"
"|PLOT"	"NL woord -JS"
"|GRAF"	"NL woord -JS"
"|BAKKER"	"NL woord -JS"
"|SCHAAL"	"NL woord -JS"
"|NEE"	"NL woord -JS"
"|DAL"	"NL woord -JS"
"|KEK"	"nl woord -JS"
"|KOPER"	"nl woord -JS"
"|DAN"	"nl woord -JS"
"|WALSER"	"nl woord/komt voor in citaat - JS"
"|FROMMELT"	"nl woord/komt voor in citaat - JS"
"|TAM"	"nl woord/komt voor in citaat - JS"
"|STOTTER"	"nl woord/komt voor in citaat - JS"
"|BRAND"	"nl woord/komt voor in citaat - JS"
"|MAAT"	"nl woord/komt voor in citaat - JS"
"|EREN"	"nl woord/komt voor in citaat - JS"
"|BOND"	"NL woord/veelvoorkomende achternaam - JS"
"|COUR"	"NL/FR woord - JS"
"|BACH"	"o.m. bedrijfsnaam - JS"
"|TOPIC"	"onderwerp' in het engels en voorkomend als bedrijfsnaam -JS"
"|ANDREWS"	"onderwijsinstelling - JS"
"|OCULIST"	"oogarts - JS"
"|BERBER"	"oorspronkelijke inwoners Noord-Afrika - JS"
"|KWIEK"	"opgewekt/plaatsnaam - JS"
"|HYDE"	"park - JS"
"|STELE"	"pilaar/archeologische term - JS"
"|STEIN"	"plaats in Nederland - JS"
"|NARIN"	"plaats in Sloveniï¿½"
"|DUONG"	"plaatsnaam - JS"
"|HEINO"	"plaatsnaam - JS"
"|BOKAN"	"plaatsnaam - JS"
"|MORONI"	"plaatsnaam - JS"
"|MARTA"	"plaatsnaam - JS"
"|LINDON"	"plaatsnaam - JS"
"|ANNEN"	"plaatsnaam - JS"
"|NADOR"	"plaatsnaam - JS"
"|KOSTI"	"plaatsnaam - JS"
"|ROHDE"	"plaatsnaam - JS"
"|YAYLA"	"plaatsnaam - JS"
"|ERDEMLI"	"plaatsnaam - JS"
"|HORSHAM"	"plaatsnaam - JS"
"|BEKE"	"plaatsnaam - JS"
"|HORST"	"plaatsnaam - JS"
"|ASKAR"	"plaatsnaam - JS"
"|VELLA"	"plaatsnaam - JS"
"|SAN"	"plaatsnaam - JS"
"|SAMPSON"	"plaatsnaam - JS"
"|WINDSOR"	"plaatsnaam - JS"
"|SALERNO"	"plaatsnaam - JS"
"|HORN"	"plaatsnaam - JS"
"|QING"	"plaatsnaam - JS"
"|VEIT"	"plaatsnaam - JS"
"|DORNBACH"	"plaatsnaam - JS"
"|WARWICK"	"plaatsnaam - JS"
"|ZELE"	"plaatsnaam - JS"
"|ARRAS"	"plaatsnaam - JS"
"|VELICKO"	"plaatsnaam - JS"
"|BUDA"	"plaatsnaam en gebergte - JS"
"|LUKA"	"plaatsnaam in Bosniï¿½ - JS"
"|ENEA"	"plaatsnaam in Italiï¿½ - JS"
"|KARAMAN"	"plaatsnaam in Turkije -JS"
"|MAIDSTONE"	"plaatsnaam -JS"
"|TIMUR"	"plaatsnaam -JS"
"|GIURGIU"	"plaatsnaam -JS"
"|SAVOIA"	"plaatsnaam -JS"
"|CAMPELLO"	"plaatsnaam -JS"
"|CHARLTON"	"plaatsnaam -JS"
"|KALLO"	"plaatsnaam -JS"
"|LALE"	"plaatsnaam -JS"
"|TUREK"	"plaatsnaam -JS"
"|CASTELL"	"plaatsnaam -JS"
"|BUCHS"	"plaatsnaam -JS"
"|SANTOS"	"plaatsnaam -JS"
"|MIDDELBURG"	"plaatsnaam -JS"
"|IRVINE"	"plaatsnaam -JS"
"|ROJE"	"plaatsnaam Sloveniï¿½/bedrijfsnaam - JS"
"|HURST"	"plaatsnaam/auteur -JS"
"|OMMER"	"plaatsnaam/bedrijfsnaam -JS"
"|MELNIK"	"plaatsnaam/merk - JS"
"|KATS"	"plaatsnaam/veelvoorkomende achternaam -JS"
"|SALI"	"plaatsnaam/veelvoorkomende achternaam -JS"
"|HAGEN"	"plant/achternaam -JS"
"|NATALE"	"post natale depressie -JS"
"|MEDVEDEV"	"premier en voormalig president Rusland - JS"
"|ASSAD"	"president Syriï¿½"
"|SULTAN"	"prins/koning -JS"
"|EXEL"	"programma -JS"
"|ORAN"	"provincie - JS"
"|LOGAR"	"provincie in Afghanistan - JS"
"|ISLAM"	"religie - JS"
"|RAMADAN"	"religieuze traditie voor moslims - JS"
"|WEST"	"richting/bedrijfsnaam /enzo-JS"
"|LUTS"	"rivier - JS"
"|MAAS"	"rivier - JS"
"|GALLO"	"Romeinse periode/merknaam - JS"
"|STEINER"	"Rudolf Steiner School - JS"
"|SAS"	"sas van gent' is een gemeente vlakbij Terneuze -JS"
"|RICHTER"	"schaal van richter/ veelvoorkomende achternaam -JS"
"|TINNER"	"schoonmaakmiddel - JS"
"|PINTER"	"schrijfer toneelstuk en komt eenmaal voor op rechtspraak. Geen verwijzing naar de EHRM uitspraak gevonden -JS"
"|CONRAD"	"schrijver/bedrijfsnaam - JS"
"|KAFKA"	"schrijver/beschrijving van het optreden van de overheid - JS"
"|HAMLETT"	"shakespeare"
"|LEONE"	"Sierre Leone' - JS"
"|DUN"	"slank/ Nederlands woord - JS"
"|SLOVAK"	"Slowakije in het Engels - JS"
"|SOFI"	"sofi-nummer - JS"
"|KOZAK"	"soort koek - JS"
"|GALLOWAY"	"soort runderen - JS"
"|SPANG"	"spang-gemeenten - JS"
"|BUREA"	"spelfout voor bureau - JS"
"|MARTE"	"spelfout voor mate - JS"
"|PATTA"	"spreektaal voor schoen - JS"
"|RIPPE"	"spreektaal voor stelen/komt in citaat voor - JS"
"|BRUXELLES"	"stad - JS"
"|DALLAS"	"stad in de verenigde staten - Js"
"|SOPOT"	"stad in Polen - JS"
"|ARENA"	"stadion - JS"
"|WARREN"	"straatnaam - JS"
"|DE WEER"	"straatnaam -JS"
"|HORNER"	"syndroom"
"|WILKIE"	"syndroom - JS"
"|IHSAN"	"taal -JS"
"|EK"	"te algemeen"
"|FORBES"	"tijdschrift/veelvoorkomende achternaam - JS"
"|BEKDEMIR"	"tolk -JS"
"|SENDA"	"type bromfiets"
"|ISOP"	"typefout voor ""is op"" - JS"
"|ZIC"	"typefouten voor 'zich' - JS"
"|OKAY"	"Uitdrukking - JS"
"|BAH"	"uitdrukking die in citaten kan voorkomen/afkorting - JS"
"|GOH"	"uitdrukking. Komt ruim 40 keer voor op rechtspraak. Vaak in citaten die zijn weergegeven - JS"
"|PARADISO"	"uitgaansgelegendheid - JS"
"|EKER"	"uitspraak van het HvJ ( C-386/95)"
"|KUGLER"	"uitspraak van het HvJ ( HvJ EU 10 september 2002, C-141/00 )"
"|EL MORABIT"	"Uitspraak van het HvJ met dezelfde naam (T-37/07 en T-323/07) -JS"
"|SIMIC"	"uitspraak van het ICTR met die naam"
"|BACCINI"	"uitspraak van HvJ met dezelfde naam (232/82) -JS"
"|HARWARD"	"universiteit - JS"
"|PAPA"	"vader - JS"
"|TOPA"	"vakbond/stad - JS"
"|IS"	"van het werkwoord 'zijn' en verwijzing naar de 'islamitische staat' -JS"
"|MARRA"	"veee"
"|JEANS"	"veel gebruikt engels woord"
"|JUDGE"	"veel voorkomend engels woord op rechtspraak - JS"
"|DIMITROVA"	"veel voorkomende achternaam van gemachtigde - JS"
"|SAT"	"veelgebruikt als afkorting voor diverse zaken -JS"
"|ENE"	"veelgebruikt woord"
"|ALP"	"veelgebruikte afkorting - JS"
"|I. D."	"veelgebruikte afkorting - JS"
"|LAME"	"veelgebruikte afkorting in zaaknummers op rechtspraak - JS"
"|SCHUITEMAKER"	"veelvoor"
"|WOS"	"veelvoorkomend als afkorting voor de Wet oorlogsmisdrijven (oud) en een bedrijf -JS"
"|DEAR"	"veelvoorkomend engels woord in citaten op rechtspraak - JS"
"|BOD"	"veelvoorkomend van bv: het werkwoord 'bieden' -JS"
"|BORG"	"veelvoorkomend woord bij bv huurzaken -JS"
"|OLSSON"	"veelvoorkomende achternaam"
"|OSMAN"	"veelvoorkomende achternaam - JS"
"|ANDERSSON"	"veelvoorkomende achternaam - JS"
"|KOSE"	"veelvoorkomende achternaam - JS"
"|ORMAN"	"veelvoorkomende achternaam - JS"
"|WERNER"	"veelvoorkomende achternaam - JS"
"|CETIN"	"veelvoorkomende achternaam - JS"
"|BALA"	"veelvoorkomende achternaam - JS"
"|SCHALK"	"veelvoorkomende achternaam - JS"
"|BAUER"	"veelvoorkomende achternaam - JS"
"|ERKAN"	"veelvoorkomende achternaam - JS"
"|ROSSI"	"veelvoorkomende achternaam - JS"
"|WELLS"	"veelvoorkomende achternaam - JS"
"|FOSTER"	"veelvoorkomende achternaam - JS"
"|SAWYER"	"veelvoorkomende achternaam - JS"
"|HODGKINS"	"veelvoorkomende achternaam - JS"
"|BECK"	"veelvoorkomende achternaam - JS"
"|LEMMER"	"veelvoorkomende achternaam - JS"
"|VAN INGEN"	"veelvoorkomende achternaam - JS"
"|LLOYD"	"veelvoorkomende achternaam - JS"
"|ROBERTSON"	"veelvoorkomende achternaam - JS"
"|SAADI"	"veelvoorkomende achternaam - JS"
"|BROOKS"	"veelvoorkomende achternaam - JS"
"|SANDERS"	"veelvoorkomende achternaam - JS"
"|COURTNEY"	"veelvoorkomende achternaam - JS"
"|SCHMID"	"veelvoorkomende achternaam - JS"
"|SCHUMACHER"	"veelvoorkomende achternaam - JS"
"|GEERINGS"	"veelvoorkomende achternaam - JS"
"|HAASE"	"veelvoorkomende achternaam - JS"
"|YOUSSEF"	"veelvoorkomende achternaam - JS"
"|KARABULUT"	"veelvoorkomende achternaam - JS"
"|GOODWIN"	"veelvoorkomende achternaam - JS"
"|HANSEN"	"veelvoorkomende achternaam - JS"
"|ROBERTS"	"veelvoorkomende achternaam - JS"
"|LARSSON"	"veelvoorkomende achternaam - JS"
"|PEREZ"	"veelvoorkomende achternaam - JS"
"|VAN VONDEL"	"veelvoorkomende achternaam - JS"
"|BURAK"	"veelvoorkomende achternaam - JS"
"|SULTANI"	"veelvoorkomende achternaam - JS"
"|AL FAYED"	"veelvoorkomende achternaam - JS"
"|SHARIF"	"veelvoorkomende achternaam - JS"
"|KESSLER"	"veelvoorkomende achternaam - JS"
"|BAGCI"	"veelvoorkomende achternaam - JS"
"|HENDRIKS"	"veelvoorkomende achternaam - JS"
"|BASHIR"	"veelvoorkomende achternaam - JS"
"|DUPUIS"	"veelvoorkomende achternaam - JS"
"|CHEN"	"veelvoorkomende achternaam - JS"
"|KAISER"	"veelvoorkomende achternaam - JS"
"|COLLINS"	"veelvoorkomende achternaam - JS"
"|DONNER"	"veelvoorkomende achternaam - JS"
"|JASAR"	"veelvoorkomende achternaam - JS"
"|PETERSEN"	"veelvoorkomende achternaam - JS"
"|WITT"	"veelvoorkomende achternaam - JS"
"|HUSSEIN"	"veelvoorkomende achternaam - JS"
"|VAN DER VELDEN"	"veelvoorkomende achternaam - JS"
"|VERAART"	"veelvoorkomende achternaam - JS"
"|HOBBS"	"veelvoorkomende achternaam - JS"
"|STEVENS"	"veelvoorkomende achternaam - JS"
"|KLASEN"	"veelvoorkomende achternaam - JS"
"|BLAKE"	"veelvoorkomende achternaam - JS"
"|BARROW"	"veelvoorkomende achternaam - JS"
"|PEARSON"	"veelvoorkomende achternaam - JS"
"|WALKER"	"veelvoorkomende achternaam - JS"
"|STORK"	"veelvoorkomende achternaam - JS"
"|YASAR"	"veelvoorkomende achternaam - JS"
"|CLEMENT"	"veelvoorkomende achternaam - JS"
"|BULUT"	"veelvoorkomende achternaam - JS"
"|TARIQ"	"veelvoorkomende achternaam - JS"
"|SIEBERT"	"veelvoorkomende achternaam - JS"
"|MAYER"	"veelvoorkomende achternaam - JS"
"|KRAMER"	"veelvoorkomende achternaam - JS"
"|HOON"	"veelvoorkomende achternaam - JS"
"|MENDES"	"veelvoorkomende achternaam - JS"
"|ATKIN"	"veelvoorkomende achternaam - JS"
"|OZTOPRAK"	"veelvoorkomende achternaam - JS"
"|GOMES"	"veelvoorkomende achternaam - JS"
"|BAYRAK"	"veelvoorkomende achternaam - JS"
"|DE SOUSA"	"veelvoorkomende achternaam - JS"
"|VAN GILST"	"veelvoorkomende achternaam - JS"
"|SCHENKEL"	"veelvoorkomende achternaam - JS"
"|KELES"	"veelvoorkomende achternaam - JS"
"|BAUMANN"	"veelvoorkomende achternaam - JS"
"|KAUFMANN"	"veelvoorkomende achternaam - JS"
"|HOFMAN"	"veelvoorkomende achternaam - JS"
"|FABER"	"veelvoorkomende achternaam - JS"
"|DUMONT"	"veelvoorkomende achternaam - JS"
"|BRINKS"	"veelvoorkomende achternaam - JS"
"|LOPES"	"veelvoorkomende achternaam - JS"
"|HUDSON"	"veelvoorkomende achternaam - JS"
"|HUSAIN"	"veelvoorkomende achternaam - JS"
"|KUIJPER"	"veelvoorkomende achternaam - JS"
"|ROMIJN"	"veelvoorkomende achternaam - JS"
"|FISCHLER"	"veelvoorkomende achternaam - JS"
"|HOOGENDIJK"	"veelvoorkomende achternaam - JS"
"|KAPTAN"	"veelvoorkomende achternaam - JS"
"|BLOMMEN"	"veelvoorkomende achternaam - JS"
"|VAN ROSSEM"	"veelvoorkomende achternaam - JS"
"|VITTERS"	"veelvoorkomende achternaam - JS"
"|AALMOES"	"veelvoorkomende achternaam - JS"
"|MC DONALD"	"veelvoorkomende achternaam - JS"
"|WARD"	"veelvoorkomende achternaam - JS"
"|KROL"	"veelvoorkomende achternaam - JS"
"|PRONK"	"veelvoorkomende achternaam - JS"
"|DAWSON"	"veelvoorkomende achternaam - JS"
"|CORNELIS"	"veelvoorkomende achternaam - JS"
"|VAN DER GRAAF"	"veelvoorkomende achternaam - JS"
"|WAGENAAR"	"veelvoorkomende achternaam - JS"
"|LENAERTS"	"veelvoorkomende achternaam - JS"
"|LINDBERG"	"veelvoorkomende achternaam - JS"
"|TOPRAK"	"veelvoorkomende achternaam - JS"
"|SCHREIBER"	"veelvoorkomende achternaam - JS"
"|STEUR"	"veelvoorkomende achternaam - JS"
"|VERMEULEN"	"veelvoorkomende achternaam - JS"
"|ERDOGAN"	"veelvoorkomende achternaam - JS"
"|TEKIN"	"veelvoorkomende achternaam - JS"
"|HUSZAR"	"veelvoorkomende achternaam (griffier) - JS"
"|AKTAS"	"veelvoorkomende achternaam en bedrijfsnaam - JS"
"|NELISSEN"	"veelvoorkomende achternaam -JS"
"|DEES"	"veelvoorkomende achternaam -JS"
"|VAN DEN BERG"	"veelvoorkomende achternaam -JS"
"|BINGOL"	"veelvoorkomende achternaam -JS"
"|FELLER"	"veelvoorkomende achternaam -JS"
"|BRAUER"	"veelvoorkomende achternaam -JS"
"|PAVIC"	"veelvoorkomende achternaam -JS"
"|OZER"	"veelvoorkomende achternaam -JS"
"|COBAN"	"veelvoorkomende achternaam -JS"
"|YUSUF"	"veelvoorkomende achternaam -JS"
"|OCAK"	"veelvoorkomende achternaam -JS"
"|SEVIM"	"veelvoorkomende achternaam -JS"
"|OZTURK"	"veelvoorkomende achternaam -JS"
"|AKBULUT"	"veelvoorkomende achternaam -JS"
"|WATKINS"	"veelvoorkomende achternaam -JS"
"|CELEBI"	"veelvoorkomende achternaam -JS"
"|ELIAS"	"veelvoorkomende achternaam -JS"
"|YAVUZ"	"veelvoorkomende achternaam -JS"
"|RASMUSSEN"	"veelvoorkomende achternaam -JS"
"|STEPHENS"	"veelvoorkomende achternaam -JS"
"|KURT"	"veelvoorkomende achternaam -JS"
"|MENDEL"	"veelvoorkomende achternaam -JS"
"|TOSUN"	"veelvoorkomende achternaam -JS"
"|BARIS"	"veelvoorkomende achternaam -JS"
"|HOUTMAN"	"veelvoorkomende achternaam -JS"
"|SHALA"	"veelvoorkomende achternaam -JS"
"|AKDEMIR"	"veelvoorkomende achternaam -JS"
"|VARGA"	"veelvoorkomende achternaam -JS"
"|BERGER"	"veelvoorkomende achternaam -JS"
"|WILSON"	"veelvoorkomende achternaam -JS"
"|VOORHUIS"	"veelvoorkomende achternaam -JS"
"|TOMA"	"veelvoorkomende achternaam -JS"
"|KIMMEL"	"veelvoorkomende achternaam -JS"
"|WILLIAMS"	"veelvoorkomende achternaam -JS"
"|PETERSON"	"veelvoorkomende achternaam -JS"
"|HOLMES"	"veelvoorkomende achternaam -JS"
"|JONES"	"veelvoorkomende achternaam -JS"
"|TURNER"	"veelvoorkomende achternaam -JS"
"|KATZ"	"veelvoorkomende achternaam -JS"
"|CHRISTENSEN"	"veelvoorkomende achternaam -JS"
"|ULLMANN"	"veelvoorkomende achternaam -JS"
"|DEURING"	"veelvoorkomende achternaam -JS"
"|ZIMMERMANN"	"veelvoorkomende achternaam -JS"
"|FRIJNS"	"veelvoorkomende achternaam -JS"
"|BELL"	"veelvoorkomende achternaam -JS"
"|HELWIG"	"veelvoorkomende achternaam -JS"
"|WRIGHT"	"veelvoorkomende achternaam -JS"
"|HELMER"	"veelvoorkomende achternaam -JS"
"|OWEN"	"veelvoorkomende achternaam -JS"
"|REMMERSWAAL"	"veelvoorkomende achternaam -JS"
"|MILLER"	"veelvoorkomende achternaam -JS"
"|GILBERT"	"veelvoorkomende achternaam -JS"
"|JACKSON"	"veelvoorkomende achternaam -JS"
"|EDWARDS"	"veelvoorkomende achternaam -JS"
"|ERDEM"	"veelvoorkomende achternaam -JS"
"|MATHIEU"	"veelvoorkomende achternaam -JS"
"|McDONALD"	"veelvoorkomende achternaam -JS"
"|DOST"	"veelvoorkomende achternaam -JS"
"|BOVE"	"veelvoorkomende achternaam -JS"
"|UGUR"	"veelvoorkomende achternaam op rechtspraak - JS"
"|SAMAN"	"veelvoorkomende achternaam op rechtspraak - JS"
"|PFEIFER"	"veelvoorkomende achternaam op rechtspraak -JS"
"|VAN ZANDBERGEN"	"veelvoorkomende achternaam van gemachtigde of advocaat - JS"
"|LOWE"	"veelvoorkomende achternaam/bedrijfsnaam - JS"
"|TUNA"	"veelvoorkomende achternaam/tonijn in het Engels -JS"
"|ROBINSON"	"veelvoorkomende achternaam/tv programma - JS"
"|DEC"	"veelvoorkomende afkorting - JS"
"|AYDEMIR"	"veelvoorkomende afkorting - JS"
"|WIENER"	"veelvoorkomende bedrijfsnaam - JS"
"|SEAL"	"veelvoorkomende bedrijfsnaam - JS"
"|ZIEGLER"	"veelvoorkomende bedrijfsnaam - JS"
"|GREENS"	"veelvoorkomende bedrijfsnaam - JS"
"|BAUDOIN"	"veelvoorkomende bedrijfsnaam en achternaam - JS"
"|HOFFER"	"veelvoorkomende naam"
"|ALI"	"veelvoorkomende naam"
"|PASCAL"	"veelvoorkomende naam -  JS"
"|RICHARDSON"	"veelvoorkomende naam -  JS"
"|ELLIS"	"veelvoorkomende naam -  JS"
"|STRAUS"	"veelvoorkomende naam -  JS"
"|VINKS"	"veelvoorkomende naam -  JS"
"|EVEREST"	"veelvoorkomende naam - JS"
"|VANDERLINDEN"	"veelvoorkomende naam - JS"
"|DRAGAN"	"veelvoorkomende naam - JS"
"|ANTON"	"veelvoorkomende naam - JS"
"|SCHMITZ"	"veelvoorkomende naam - JS"
"|IVAN"	"veelvoorkomende naam - JS"
"|YILMAZ"	"veelvoorkomende naam - JS"
"|DEMIR"	"veelvoorkomende naam - JS"
"|BECKER"	"veelvoorkomende naam - JS"
"|DABROWSKI"	"veelvoorkomende naam - JS"
"|WOZNIAK"	"veelvoorkomende naam - JS"
"|ILIC"	"veelvoorkomende naam - JS"
"|GIL"	"veelvoorkomende naam - JS"
"|GABRIEL"	"veelvoorkomende naam - JS"
"|KROPS"	"veelvoorkomende naam - JS"
"|NILSEN"	"veelvoorkomende naam - JS"
"|AKKAYA"	"veelvoorkomende naam - JS"
"|LEFEVRE"	"veelvoorkomende naam - JS"
"|DAVISON"	"veelvoorkomende naam - JS"
"|UYAR"	"veelvoorkomende naam - JS"
"|NITA"	"veelvoorkomende naam - JS"
"|BIJLEVELD"	"veelvoorkomende naam - JS"
"|SANNA"	"veelvoorkomende naam - JS"
"|EBBINGE"	"veelvoorkomende naam - JS"
"|JASPER"	"veelvoorkomende naam - JS"
"|NICHOLAS"	"veelvoorkomende naam - JS"
"|BLOM"	"veelvoorkomende naam - JS"
"|BERG"	"veelvoorkomende naam - JS"
"|SASSEN"	"veelvoorkomende naam - JS"
"|CRAIG"	"veelvoorkomende naam - JS"
"|WILLE"	"veelvoorkomende naam - JS"
"|LIE"	"veelvoorkomende naam - JS"
"|FREEMAN"	"veelvoorkomende naam - JS"
"|CAROLA"	"veelvoorkomende naam - JS"
"|ARNO"	"veelvoorkomende naam - JS"
"|HARPER"	"veelvoorkomende naam - JS"
"|HILDEN"	"veelvoorkomende naam - JS"
"|GIBBS"	"veelvoorkomende naam - JS"
"|GRAY"	"veelvoorkomende naam - JS"
"|HERMAN"	"veelvoorkomende naam - JS"
"|LI"	"veelvoorkomende naam - JS"
"|OMAR"	"veelvoorkomende naam - JS"
"|OGUR"	"veelvoorkomende naam - JS"
"|GRACE"	"veelvoorkomende naam - JS"
"|STUART"	"veelvoorkomende naam - JS"
"|CARTER"	"veelvoorkomende naam - JS"
"|ROSS"	"veelvoorkomende naam - JS"
"|DE GROOT"	"veelvoorkomende naam - JS"
"|DE BRUYN"	"veelvoorkomende naam - JS"
"|EVERS"	"veelvoorkomende naam - JS"
"|PETRA"	"veelvoorkomende naam - JS"
"|AERTS"	"veelvoorkomende naam - JS"
"|GULEC"	"veelvoorkomende naam - JS"
"|GILES"	"veelvoorkomende naam - JS"
"|GIERLING"	"veelvoorkomende naam - JS"
"|AHMET"	"veelvoorkomende naam - JS"
"|MEHMETI"	"veelvoorkomende naam - JS"
"|URI"	"veelvoorkomende naam - JS"
"|BEAVER"	"veelvoorkomende naam - JS"
"|BERNARD"	"veelvoorkomende naam - JS"
"|HELMERS"	"veelvoorkomende naam - JS"
"|LAURENS"	"veelvoorkomende naam - JS"
"|RYAN"	"veelvoorkomende naam - JS"
"|HAMMERSTEIN"	"veelvoorkomende naam - JS"
"|INNES"	"veelvoorkomende naam - JS"
"|VAN SCHIJNDEL"	"veelvoorkomende naam - JS"
"|REMMERS"	"veelvoorkomende naam - JS"
"|HILDEBRAND"	"veelvoorkomende naam - JS"
"|WOCKEL"	"veelvoorkomende naam - JS"
"|VAN VLIET"	"veelvoorkomende naam - JS"
"|BRUCE"	"veelvoorkomende naam - JS"
"|KNIGHT"	"veelvoorkomende naam - JS"
"|SELMA"	"veelvoorkomende naam - JS"
"|HELLE"	"veelvoorkomende naam - JS"
"|VAN MECHELEN"	"veelvoorkomende naam - JS"
"|WESTER"	"veelvoorkomende naam - JS"
"|BARRON"	"veelvoorkomende naam - JS"
"|RODGERS"	"veelvoorkomende naam - JS"
"|POTTER"	"veelvoorkomende naam - JS"
"|GRAHAM"	"veelvoorkomende naam - JS"
"|ROBINS"	"veelvoorkomende naam - JS"
"|ZEGWAARD"	"veelvoorkomende naam - JS"
"|KLIP"	"veelvoorkomende naam - JS"
"|LEO"	"veelvoorkomende naam - JS"
"|DE HAAN"	"veelvoorkomende naam - JS"
"|DICK"	"veelvoorkomende naam - JS"
"|MOSTERD"	"veelvoorkomende naam - JS"
"|SPIELE"	"veelvoorkomende naam - JS"
"|VAN DER TAS"	"veelvoorkomende naam - JS"
"|VAN BOMMEL"	"veelvoorkomende naam - JS"
"|TIMMER"	"veelvoorkomende naam - JS"
"|RUSSELL"	"veelvoorkomende naam - JS"
"|ELTON"	"veelvoorkomende naam - JS"
"|CHESTER"	"veelvoorkomende naam - JS"
"|NIEMAN"	"veelvoorkomende naam - JS"
"|ERIKSEN"	"veelvoorkomende naam - JS"
"|DE HAES"	"veelvoorkomende naam - JS"
"|VAN RAALTE"	"veelvoorkomende naam - JS"
"|GREGORY"	"veelvoorkomende naam - JS"
"|VAN ULDEN"	"veelvoorkomende naam - JS"
"|HOFER"	"veelvoorkomende naam - JS"
"|HAMILTON"	"veelvoorkomende naam - JS"
"|PETTERSSON"	"veelvoorkomende naam - JS"
"|FLEMING"	"veelvoorkomende naam - JS"
"|SAUNDERS"	"veelvoorkomende naam - JS"
"|MEISTER"	"veelvoorkomende naam - JS"
"|HOVING"	"veelvoorkomende naam - JS"
"|STEDMAN"	"veelvoorkomende naam - JS"
"|NYBERG"	"veelvoorkomende naam - JS"
"|GERRARD"	"veelvoorkomende naam - JS"
"|BUCKLEY"	"veelvoorkomende naam - JS"
"|MICHEL"	"veelvoorkomende naam - JS"
"|DE KOK"	"veelvoorkomende naam - JS"
"|GUILLOT"	"veelvoorkomende naam - JS"
"|HALLER"	"veelvoorkomende naam - JS"
"|BRUNNER"	"veelvoorkomende naam - JS"
"|SCHMITT"	"veelvoorkomende naam - JS"
"|SLOBODAN"	"veelvoorkomende naam - JS"
"|WITNEY"	"veelvoorkomende naam - JS"
"|GUNTHER"	"veelvoorkomende naam - JS"
"|BASTA"	"veelvoorkomende naam - JS"
"|TY"	"veelvoorkomende naam - JS"
"|REUTER"	"veelvoorkomende naam - JS"
"|MEIJER"	"veelvoorkomende naam - JS"
"|MIDDLETON"	"veelvoorkomende naam - JS"
"|MURDOCH"	"veelvoorkomende naam - JS"
"|NICK"	"veelvoorkomende naam - JS"
"|VAN GIESSEN"	"veelvoorkomende naam - JS"
"|KAIRA"	"veelvoorkomende naam - JS"
"|JONAS"	"veelvoorkomende naam - JS"
"|FOUQUET"	"veelvoorkomende naam - JS"
"|BRYAN"	"veelvoorkomende naam - JS"
"|GILL"	"veelvoorkomende naam - JS"
"|RUSSEL"	"veelvoorkomende naam - JS"
"|VOLKERT"	"veelvoorkomende naam - JS"
"|KLOPPER"	"veelvoorkomende naam - JS"
"|PETERS"	"veelvoorkomende naam - JS"
"|HAUSER"	"veelvoorkomende naam - JS"
"|JENNY"	"veelvoorkomende naam - JS"
"|BULLOCK"	"veelvoorkomende naam - JS"
"|FLANDERS"	"veelvoorkomende naam - JS"
"|DAVY"	"veelvoorkomende naam - JS"
"|VAN DER TANG"	"veelvoorkomende naam - JS"
"|KREMERS"	"veelvoorkomende naam - JS"
"|HOLS"	"veelvoorkomende naam - JS"
"|ROESTENBURG"	"veelvoorkomende naam - JS"
"|JACQ"	"veelvoorkomende naam - JS"
"|TEN BERGE"	"veelvoorkomende naam - JS"
"|KLERKS"	"veelvoorkomende naam - JS"
"|VAN SOEST"	"veelvoorkomende naam - JS"
"|PARKER"	"veelvoorkomende naam - JS"
"|VAN REESWIJK"	"veelvoorkomende naam - JS"
"|REES"	"Verleden tijd van rijzen - MvO"
"|MULDERS"	"veelvoorkomende naam - JS"
"|SCHOUTEN"	"veelvoorkomende naam - JS"
"|STEIJNEN"	"veelvoorkomende naam - JS"
"|BEERDEN"	"veelvoorkomende naam - JS"
"|VAN DEN DUNGEN"	"veelvoorkomende naam - JS"
"|ROSENBERG"	"veelvoorkomende naam - JS"
"|REEVE"	"veelvoorkomende naam - JS"
"|FINNEGAN"	"veelvoorkomende naam - JS"
"|DUPONT"	"veelvoorkomende naam - JS"
"|DE MOOR"	"veelvoorkomende naam - JS"
"|SPRINGINTVELD"	"veelvoorkomende naam - JS"
"|VEENSTRA"	"veelvoorkomende naam - JS"
"|VAN DE HURK"	"veelvoorkomende naam - JS"
"|FORSTER"	"veelvoorkomende naam - JS"
"|HARDY"	"veelvoorkomende naam - JS"
"|VELTHUIS"	"veelvoorkomende naam - JS"
"|HEIN"	"veelvoorkomende naam - JS"
"|VAN EIS"	"veelvoorkomende naam - JS"
"|KLAAS"	"veelvoorkomende naam - JS"
"|SAIDI"	"veelvoorkomende naam - JS"
"|MICHEAL"	"veelvoorkomende naam - JS"
"|ROZENDALE"	"veelvoorkomende naam - JS"
"|DANNER"	"veelvoorkomende naam - JS"
"|TRACEY"	"veelvoorkomende naam - JS"
"|GIBSON"	"veelvoorkomende naam - JS"
"|DE VRIES"	"veelvoorkomende naam - JS"
"|DANIELS"	"veelvoorkomende naam - JS"
"|PLASMAN"	"veelvoorkomende naam - JS"
"|WESTERBERG"	"veelvoorkomende naam - JS"
"|STEENS"	"veelvoorkomende naam - JS"
"|AKHTAR"	"veelvoorkomende naam - JS"
"|JANSEN"	"veelvoorkomende naam - JS"
"|VAN LAAK"	"veelvoorkomende naam - JS"
"|BODDAERT"	"veelvoorkomende naam - JS"
"|HESS"	"veelvoorkomende naam - JS"
"|NIJS"	"veelvoorkomende naam - JS"
"|DANKERS"	"veelvoorkomende naam - JS"
"|VAN DER SLOOT"	"veelvoorkomende naam - JS"
"|ROELOFS"	"veelvoorkomende naam - JS"
"|DIANA"	"veelvoorkomende naam - JS"
"|KERKHOVEN"	"veelvoorkomende naam - JS"
"|KOSTER"	"veelvoorkomende naam - JS"
"|BORGERS"	"veelvoorkomende naam - JS"
"|OERLEMANS"	"veelvoorkomende naam - JS"
"|VAN DE VIN"	"veelvoorkomende naam - JS"
"|VAN DUNGEN"	"veelvoorkomende naam - JS"
"|VAN LIESHOUT"	"veelvoorkomende naam - JS"
"|DIJKSTRA"	"veelvoorkomende naam - JS"
"|BAAKMAN"	"veelvoorkomende naam - JS"
"|KRONENBURG"	"veelvoorkomende naam - JS"
"|VAN ZOMEREN"	"veelvoorkomende naam - JS"
"|AN"	"veelvoorkomende naam - JS"
"|CLINTON"	"veelvoorkomende naam - JS"
"|AARTS"	"veelvoorkomende naam - JS"
"|DE JONG"	"veelvoorkomende naam - JS"
"|BECKERS"	"veelvoorkomende naam - JS"
"|WASSINK"	"veelvoorkomende naam - JS"
"|HOPKINS"	"veelvoorkomende naam - JS"
"|JACOBSEN"	"veelvoorkomende naam - JS"
"|ABBOTT"	"veelvoorkomende naam - JS"
"|WEISE"	"veelvoorkomende naam - JS"
"|LINDEN"	"veelvoorkomende naam - JS"
"|PRINCE"	"veelvoorkomende naam - JS"
"|OLSEN"	"veelvoorkomende naam - JS"
"|VAN DER LEER"	"veelvoorkomende naam - JS"
"|SIMPSON"	"veelvoorkomende naam - JS"
"|ARNOLD"	"veelvoorkomende naam - JS"
"|ATSMA"	"veelvoorkomende naam - JS"
"|PAUWELS"	"veelvoorkomende naam - JS"
"|WEIJDEN"	"veelvoorkomende naam - JS"
"|LOWES"	"veelvoorkomende naam - JS"
"|GINSBERGEN"	"veelvoorkomende naam - JS"
"|LUND"	"veelvoorkomende naam - JS"
"|ROGERS"	"veelvoorkomende naam - JS"
"|Angela"	"veelvoorkomende naam - JS"
"|SARA"	"veelvoorkomende naam - JS"
"|AZIZI"	"veelvoorkomende naam - JS"
"|SANDBERG"	"veelvoorkomende naam - JS"
"|SALEH"	"veelvoorkomende naam - JS"
"|HOWARD"	"veelvoorkomende naam - JS"
"|KORTMANN"	"veelvoorkomende naam - JS"
"|DE SOUZA"	"veelvoorkomende naam - JS"
"|VAN BUITENEN"	"veelvoorkomende naam - JS"
"|VAN MARLE"	"veelvoorkomende naam - JS"
"|NYSSEN"	"veelvoorkomende naam - JS"
"|LINDSAY"	"veelvoorkomende naam - JS"
"|DE MOT"	"veelvoorkomende naam - JS"
"|WELTER"	"veelvoorkomende naam - JS"
"|VAN DER HEIJDEN"	"veelvoorkomende naam - JS"
"|RUTH"	"veelvoorkomende naam - JS"
"|DUINHOF"	"veelvoorkomende naam - JS"
"|RAYMOND"	"veelvoorkomende naam - JS"
"|JAKOBSSON"	"veelvoorkomende naam - JS"
"|TOMKINS"	"veelvoorkomende naam - JS"
"|BATELAAN"	"veelvoorkomende naam - JS"
"|SCHUURS"	"veelvoorkomende naam - JS"
"|FERGUSON"	"veelvoorkomende naam - JS"
"|HOLDEN"	"veelvoorkomende naam - JS"
"|MARIJNISSEN"	"veelvoorkomende naam - JS"
"|JESPERS"	"veelvoorkomende naam - JS"
"|MARCKX"	"veelvoorkomende naam - JS"
"|KAMAL"	"veelvoorkomende naam - JS"
"|VAN LEUVEN"	"veelvoorkomende naam - JS"
"|LEVY"	"veelvoorkomende naam - JS"
"|ALAM"	"veelvoorkomende naam - JS"
"|ZHOU"	"veelvoorkomende naam - JS"
"|POTCOAVA"	"veelvoorkomende naam - JS"
"|JUNIOR"	"veelvoorkomende naam - JS"
"|RUDOLF"	"veelvoorkomende naam - JS"
"|ROONEY"	"veelvoorkomende naam - JS"
"|NOBEL"	"veelvoorkomende naam - JS"
"|SCHULLER"	"veelvoorkomende naam - JS"
"|MOHAMMED"	"veelvoorkomende naam - JS"
"|MARCUS"	"veelvoorkomende naam - JS"
"|ALEXA"	"veelvoorkomende naam - JS"
"|AREND"	"veelvoorkomende naam - JS"
"|LIN"	"veelvoorkomende naam - JS"
"|MOHAMED"	"veelvoorkomende naam - JS"
"|ZWINKELS"	"veelvoorkomende naam - JS"
"|ALTHOFF"	"veelvoorkomende naam - JS"
"|SIMONS"	"veelvoorkomende naam - JS"
"|VINKE"	"veelvoorkomende naam - JS"
"|JACOBSON"	"veelvoorkomende naam - JS"
"|YILMAZ"	"veelvoorkomende naam - JS"
"|HUSSEINI"	"veelvoorkomende naam - JS"
"|VOGELSANG"	"veelvoorkomende naam - JS"
"|EL"	"veelvoorkomende naam - JS"
"|BREUKHOVEN"	"veelvoorkomende naam - JS"
"|VAN VELDEN"	"veelvoorkomende naam - JS"
"|METIN"	"veelvoorkomende naam - JS"
"|OZDEMIR"	"veelvoorkomende naam advocaat - JS"
"|ALEXANDER"	"Veelvoorkomende naam als voornaam en deelgemeente -JS"
"|MEIER"	"veelvoorkomende naam -JS"
"|RAMON"	"veelvoorkomende naam -JS"
"|BARTA"	"veelvoorkomende naam -JS"
"|CELIK"	"veelvoorkomende naam -JS"
"|SARI"	"veelvoorkomende naam -JS"
"|STROE"	"veelvoorkomende naam -JS"
"|DE BRUIN"	"veelvoorkomende naam -JS"
"|VAN GALEN"	"veelvoorkomende naam -JS"
"|PATERSON"	"veelvoorkomende naam -JS"
"|VAN DER PUTTEN"	"veelvoorkomende naam -JS"
"|PACH"	"veelvoorkomende naam- JS"
"|JANKOVIC"	"veelvoorkomende naam/deskundige - JS"
"|RAZA"	"veelvoorkomende naam/stichting - JS"
"|SCOTT"	"veelvoorkomende voor- achternaam - JS"
"|ERNEST"	"veelvoorkomende voor- achternaam - JS"
"|MAHMUT"	"veelvoorkomende voor- achternaam - JS"
"|CLARK"	"veelvoorkomende voor- achternaam - JS"
"|CLARKE"	"veelvoorkomende voor- achternaam - JS"
"|MICHAEL"	"veelvoorkomende voor- en achternaam - JS"
"|ISMAIL"	"veelvoorkomende voornaam - JS"
"|MARTIN"	"veelvoorkomende voornaam - JS"
"|ANA"	"veelvoorkomende voornaam - JS"
"|JAY"	"veelvoorkomende voornaam - JS"
"|RALPH"	"veelvoorkomende voornaam - JS"
"|THOMAS"	"veelvoorkomende voornaam - JS"
"|RASHID"	"veelvoorkomende voornaam - JS"
"|EMRE"	"veelvoorkomende voornaam - JS"
"|LUCA"	"veelvoorkomende voornaam - JS"
"|NELSON"	"veelvoorkomende voornaam - JS"
"|GEORGE"	"veelvoorkomende voornaam - JS"
"|BENJAMIN"	"veelvoorkomende voornaam - JS"
"|MILAN"	"veelvoorkomende voornaam - JS"
"|HERBERT"	"veelvoorkomende voornaam - JS"
"|MOSTAFA"	"veelvoorkomende voornaam - JS"
"|ARNAUD"	"veelvoorkomende voornaam - JS"
"|IBRAHIM"	"veelvoorkomende voornaam - JS"
"|HASAN"	"veelvoorkomende voornaam - JS"
"|MEHMET"	"veelvoorkomende voornaam - JS"
"|JOHN"	"veelvoorkomende voornaam - JS"
"|EMIR"	"veelvoorkomende voornaam - JS"
"|KIRSTEN"	"veelvoorkomende voornaam - JS"
"|ERIK"	"veelvoorkomende voornaam - JS"
"|MOHAMAD"	"veelvoorkomende voornaam - JS"
"|HASSAN"	"veelvoorkomende voornaam - JS"
"|LOUIS"	"veelvoorkomende voornaam - JS"
"|VINCENT"	"veelvoorkomende voornaam - JS"
"|ERIN"	"veelvoorkomende voornaam - JS"
"|KARIM"	"veelvoorkomende voornaam - JS"
"|NICOLAS"	"veelvoorkomende voornaam - JS"
"|EBRU"	"veelvoorkomende voornaam - JS"
"|STACEY"	"veelvoorkomende voornaam - JS"
"|BARRY"	"veelvoorkomende voornaam - JS"
"|HAKAN"	"veelvoorkomende voornaam - JS"
"|JUSTIN"	"veelvoorkomende voornaam - JS"
"|KIM"	"veelvoorkomende voornaam - JS"
"|COLIN"	"veelvoorkomende voornaam - JS"
"|GLEN"	"veelvoorkomende voornaam - JS"
"|RUDI"	"veelvoorkomende voornaam - JS"
"|SYLVESTER"	"veelvoorkomende voornaam - JS"
"|REMY"	"veelvoorkomende voornaam - JS"
"|SIMON"	"veelvoorkomende voornaam - JS"
"|EARL"	"veelvoorkomende voornaam - JS"
"|VERHOEK"	"veelvoorkomende voornaam - JS"
"|IMRE"	"veelvoorkomende voornaam - JS"
"|NICOLAI"	"veelvoorkomende voornaam - JS"
"|NICOLLE"	"veelvoorkomende voornaam - JS"
"|PETER"	"veelvoorkomende voornaam - JS"
"|YVON"	"veelvoorkomende voornaam - JS"
"|FRANCIS"	"veelvoorkomende voornaam - JS"
"|LUCAS"	"veelvoorkomende voornaam - JS"
"|KELLY"	"veelvoorkomende voornaam en bedrijfsnaam op rechtspraak - JS"
"|AHMED"	"veelvoorkomende voornaam -JS"
"|DANIEL"	"veelvoorkomende voornaam -JS"
"|ANDRE"	"veelvoorkomende voornaam- JS"
"|BERRY"	"veelvoorkomende voornaam/Engels woord - JS"
"|SAID"	"veelvoorkomende voornaam/komt voor in Engels citaten - jS"
"|PAUL"	"veelvoorkomende voornaam/merknaam -JS"
"|DE MARIA"	"veelvoorkomende zinssnede - jS"
"|MASSMANN"	"veelvuldig voorkomende achternaam - JS"
"|GASHI"	"veelvuldig voorkomende achternaam - JS"
"|OZCAN"	"veelvuldig voorkomende achternaam - JS"
"|FERNANDEZ"	"veelvuldig voorkomende achternaam - JS"
"|CIMEN"	"veelvuldig voorkomende achternaam - JS"
"|POLAK"	"veelvuldig voorkomende achternaam - JS"
"|VAN HOUT"	"veelvuldig voorkomende achternaam - JS"
"|WATTS"	"veelvuldig voorkomende bedrijsnaam / achternaam - JS"
"|BEKTAS"	"veelvuldig voorkomende naam -JS"
"|ROOVERS"	"veelvuldig voorkomende naam -JS"
"|STEFAN"	"veelvuldig voorkomende voornaam -JS"
"|BEGING"	"verleden tijd begaan - JS"
"|KAN"	"vervoeging van ww kunnen en zelfstandig naamwoord - JS"
"|HOFMANN"	"verwijzing naar een HR uitspraak (HR 26 juni 1998, LJN ZC2688, NJ 1998/767)"
"|ROG"	"vis - JS"
"|KARP"	"vissoort - JS"
"|KOT"	"Vlaams/Nederlands woord/kan in citaat voorkomen - JS"
"|EGYPTAIR"	"vliegmaatschappij - JS"
"|CROISSANT"	"voedsel - JS"
"|FORTUNA"	"voetbalclub - JS"
"|RODA"	"voetbalclub - JS"
"|P.S. V."	"voetbalclub - JS"
"|ROMANCHENKO"	"voetballer/veelvoorkomende achternaam -JS"
"|ALBANESE"	"Volk - JS"
"|DAVID"	"voor- achter- bedrijfsnaam -JS"
"|STEPHAN"	"voor- en achternaam voor advocaten, curatoren e.d. -JS"
"|ZON"	"voorkomend als de zon, zon- en feestdagen -JS"
"|M. A."	"voorletters - JS"
"|A. E."	"voorletters - JS"
"|L. S.R.L."	"voorletters - JS"
"|M.Ru."	"voorletters - JS"
"|W.G. S."	"voorletters - JS"
"|J. L.S."	"voorletters - JS"
"|R.W.-L."	"voorletters - JS"
"|K.-F."	"voorletters - JS"
"|E. P."	"voorletters - JS"
"|Mr T.K."	"voorletters - JS"
"|G. F."	"voorletters - JS"
"|A.Q. F."	"voorletters - JS"
"|A. A.G."	"voorletters - JS"
"|M. Cz."	"voorletters - JS"
"|MR. T.K."	"voorletters - JS"
"|MRS. AG"	"voorletters - JS"
"|F. J."	"voorletters - JS"
"|L.-G. R."	"voorletters - JS"
"|M.M"	"voorletters - JS"
"|A. P."	"voorletters - JS"
"|H.F. K-F"	"voorletters - JS"
"|A.L. H."	"voorletters - JS"
"|M. F."	"voorletters - JS"
"|H. W. K."	"voorletters - JS"
"|H. M.A."	"voorletters - JS"
"|D. B."	"voorletters - JS"
"|A. R."	"voorletters - JS"
"|A.R. D."	"voorletters - JS"
"|S.M. K."	"voorletters - JS"
"|H.F. K.-F."	"voorletters - JS"
"|D. F."	"voorletters - JS"
"|D. S."	"voorletters - JS"
"|E. A."	"voorletters - JS"
"|E. S."	"voorletters - JS"
"|I. S.-B."	"voorletters - JS"
"|A. B. A."	"voorletters - JS"
"|W. M."	"voorletters - JS"
"|S.E. K."	"voorletters - JS"
"|J.M"	"voorletters - JS"
"|J.-P. E."	"voorletters - JS"
"|M.-A.V."	"voorletters - JS"
"|J.-P. P."	"voorletters - JS"
"|H.L. W."	"voorletters - JS"
"|A.CH."	"voorletters - JS"
"|S. G.P."	"voorletters - JS"
"|A. T."	"voorletters - JS"
"|H.O."	"voorletters - JS"
"|K.A"	"voorletters - JS"
"|S. L."	"voorletters - JS"
"|F. M."	"voorletters - JS"
"|H. A."	"voorletters - JS"
"|M. T."	"voorletters - JS"
"|E. H."	"voorletters - JS"
"|M.P. M.L."	"voorletters - JS??"
"|P. ST."	"voorletters - JS??"
"|S. H."	"voorletters -JS"
"|UJ"	"voorletters -JS"
"|M.v."	"voorletters of andere afkorting -JS"
"|B. A."	"voorletters van een naam / afkorting voor Bachelor of Arts enzovoorts - JS"
"|M. M."	"voorletters/afkorting - JS"
"|K.O."	"voorletters/afkorting - JS"
"|AL.K."	"voorletters/afkorting - JS"
"|T.H.-A."	"voorletters/afkorting - JS"
"|R. H."	"voorletters/afkorting - JS"
"|WILLEM"	"voornaam - JS"
"|MURPHY"	"voornaam/achternaam -JS"
"|LIS"	"voornaam/afkorting - JS"
"|HUB"	"voornaam/afkorting - JS"
"|KUBUS"	"voorwerp - JS"
"|DISK"	"voorwerp - JS"
"|BIJL"	"voorwerp -JS"
"|KAR"	"voorwerp- JS"
"|BAK"	"voorwerp- JS"
"|DRIJFHOUT"	"voorwerp- JS"
"|KRUK"	"Voorwerp, Nederlands woord-JS"
"|KUBIK"	"vorm - JS"
"|BERRETTA"	"vuurwapen type - JS"
"|BUKS"	"wapen - JS"
"|MIKROS"	"wapen merk - JS"
"|BARRET"	"wapen/achternaam die vaak voorkomt - JS"
"|WALTER"	"wapen/voornaam - JS"
"|KUN"	"werkwoord kunnen -JS"
"|WAS"	"werkwoord/zelfstandig naamwoord -JS"
"|SEKT"	"wijn"
"|VILLA"	"woning/bedrijfsnaam - JS"
"|BRACHT"	"ww brengen - JS"
"|GEREN"	"zelfstandignaamwoord - veelvuldig rennen - JS"
"|STOLZ"	"zes keer voorkomend als achternaam/bedrijfsnaam of citaat uit duitse tekst. Geen enkele keer verwijzing naar de EHRM uitspraak - JS"
"|BOECK"	"ziektebeeld - JS"
"|NOGA"	"zoetigheid/bedrijfsnaam - JS"
"|AK"	"zou een afkorting kunnen zijn - JS"
"|GRYTA"
"|UCAR"
"|VAN HOUTEN"
"|KUZIN"
"|FORSSTROM"
"|IACOPELLI"
"|PROCOLA"
"|JOSEPH"
"|D. LTD"
"|K. KG."
"|E. & CO."
"|P. ET AL."
"|TREHOLT"
"|G. G.m.b.H."
"|G.-A."
"|E. et al."
"|S. S.-F."
"|MENDIS"
"|P. ET P."
"|C. LTD"
"|c."
"|K.S."
"|A. M."
"|A.L. (X.W.)"
"|TUTAL"
"|S. N."
"|W. J."
"|W. J.|D. P."
"|C. NG"
"|1. G.R."
"|1. G.R.|2. D.R."
"|M.AND O.M."
"|K. M."
"|G. M."
"|E. V."
"|S. D."
"|K. B."
"|R. A."
"|R. A.|W. M."
"|K. O."
"|S. M."
"|M. B."
"|J. G."
"|P. G."
"|B. V."
"|L. S."
"|Y. H."
"|R-J."
"|M-F."
"|Y.-N."
"|Mrs X."
"|H. & K."
"|Association X."
"|X. Union"
"|X. Company"
"|Family X."
"|X. Ltd."
"|X. Ltd.|Y."
"|X. Association"
"|P. Ltd."
"|LIBERAL PARTY"
"|COMPANY X."
"|TRADE UNION X."
"|X. A.G."
"|Mr."
"|Mr.|Mrs. X."
"|Dr. X."
"|F. H. jr."
"|G. W."
"|LAVRIC"
"|A.R.M"
"|M.S.-D."
"|M.S."
"|M.S.|J.S."
"|R.Sz."
"|I.S.A"
"|MO.M."
"|DMF A.S"
"|D. J."
"|TNS S.R.O."
"|RAJC"
"|R.E. BT"
"|DMF A. S."
"|FELDMAN"	"achternaam komt voor in ander verband op rechtspraak - JS"
"|LITOVCHENKO"	"achternaam van enkele sporters - JS"
"|CALO"	"afdeling school - JS"
"|BOR"	"afkorting"
"|RESS"	"afkorting - JS"
"|AGH"	"afkorting - JS"
"|BOC"	"afkorting - JS"
"|N.O."	"afkorting - JS"
"|BOSO"	"afkorting - JS"
"|GOC"	"afkorting - JS"
"|MIR"	"afkorting - JS"
"|CAPAR"	"afkorting - JS"
"|KOC"	"afkorting / naam onderwijsinstelling - JS"
"|ARGA"	"afkorting arbeidsvoorwaardenregeling gemeente Amersfoort - JS"
"|RAF"	"afkorting -JS"
"|HERZ"	"afkorting -JS"
"|EID"	"afkorting -JS"
"|BOGA"	"afkorting -JS"
"|BOG"	"afkorting -JS"
"|COVA"	"afkorting -JS"
"|JORI"	"afkorting -JS"
"|CIZ"	"afkorting/instantie -JS"
"|At.M."	"afkorting/voorletters - JS"
"|O.O."	"afkorting/voorletters -JS"
"|GROSSE"	"afschrift - JS"
"|ROYER"	"alias arrest HvJ - JS"
"|SKALKA"	"alias arrest HvJ - JS"
"|JAEGER"	"alias arrest HvJ - JS"
"|ZOTTI"	"alias arrest HvJ - JS"
"|SCHULTZ"	"Alias arrest HvJ - JS"
"|AKMAN"	"alias arrest HvJ - JS"
"|CARBONI"	"alias arrest HvJ - JS"
"|SANTILLO"	"alias arrest HvJ - JS"
"|HUTTON"	"alias arrest HvJ -JS"
"|OSMANI"	"alias arrest HvJ -JS"
"|HOFFMANN"	"alias arrest HvJ -JS"
"|LENZ"	"alias arrest HvJ -JS"
"|PINI"	"alias arrest HvJ -JS"
"|COSTEA"	"alias arrest HvJ -JS"
"|HENKEL NEDERLAND B.V."	"andere zaak waarin deze onderneming partij is - JS"
"|HENNIG"	"auteur -JS"
"|LEON"	"automerk/voornaam -JS"
"|LAKO"	"bedrijfsnaam - JS"
"|CARLSON"	"bedrijfsnaam - JS"
"|KRUG"	"bedrijfsnaam - JS"
"|WYNNE"	"bedrijfsnaam - JS"
"|ESEN"	"bedrijfsnaam - jS"
"|FONTAINE"	"bedrijfsnaam - jS"
"|MAHON"	"bedrijfsnaam - jS"
"|KADEM"	"bedrijfsnaam - JS"
"|BOHMER"	"bedrijfsnaam - JS"
"|INCE"	"bedrijfsnaam - JS"
"|LELLA"	"bedrijfsnaam - JS"
"|LAMU"	"bedrijfsnaam - JS"
"|FIRTH"	"bedrijfsnaam - JS"
"|MARCAN"	"bedrijfsnaam - JS"
"|VIDRA"	"bedrijfsnaam - JS"
"|MANNA"	"bedrijfsnaam - jS"
"|AMICI"	"bedrijfsnaam - jS"
"|EINHORN"	"bedrijfsnaam - jS"
"|VALVO"	"bedrijfsnaam - jS"
"|CAMPANA"	"bedrijfsnaam - JS"
"|GRECO"	"bedrijfsnaam - JS"
"|REINO"	"bedrijfsnaam - JS"
"|TOZZI"	"bedrijfsnaam - JS"
"|CASTELLO"	"bedrijfsnaam - JS"
"|COSTA"	"bedrijfsnaam - JS"
"|MORT"	"bedrijfsnaam - JS"
"|POLINI"	"bedrijfsnaam - JS"
"|VERMEERSCH"	"bedrijfsnaam - JS"
"|CEMAL"	"bedrijfsnaam - JS"
"|THOMA"	"bedrijfsnaam - JS"
"|MOTTA"	"bedrijfsnaam - JS"
"|SEZER"	"bedrijfsnaam - JS"
"|CELAL"	"bedrijfsnaam - JS"
"|DARBY"	"bedrijfsnaam - JS"
"|BALLESTRA"	"bedrijfsnaam - JS"
"|BROOK"	"bedrijfsnaam - JS"
"|CARDO"	"bedrijfsnaam - JS"
"|ROBBA"	"bedrijfsnaam -JS"
"|ZITO"	"bedrijfsnaam -JS"
"|JARREAU"	"bedrijfsnaam -JS"
"|ESTEVES"	"bedrijfsnaam -JS"
"|FERRETTI"	"bedrijfsnaam -JS"
"|BUCHEN"	"bedrijfsnaam -JS"
"|TOSI"	"bedrijfsnaam -JS"
"|ALTAN"	"bedrijfsnaam -JS"
"|COLELLA"	"bedrijfsnaam -JS"
"|ACETO"	"bedrijfsnaam -JS"
"|GAUDIO"	"bedrijfsnaam -JS"
"|HERTEL"	"bedrijfsnaam -JS"
"|NEILL"	"bedrijfsnaam -JS"
"|MAURER"	"bedrijfsnaam -JS"
"|CONTI"	"bedrijfsnaam -JS"
"|GODDARD"	"bedrijfsnaam -JS"
"|HAZAR"	"bedrijfsnaam -JS"
"|CONNELL"	"bedrijfsnaam -JS"
"|SCHREDER"	"bedrijfsnaam -JS"
"|PERICO"	"bedrijfsnaam -JS"
"|MARTINEZ"	"bedrijfsnaam -JS"
"|SENGEZER"	"bedrijfsnaam -JS"
"|CITTERIO"	"bedrijfsnaam -JS"
"|QUINN"	"bedrijfsnaam -JS"
"|MARTINS"	"bedrijfsnaam -JS"
"|BLOKKER"	"bedrijfsnaam -JS"
"|SERHAT"	"bedrijfsnaam -JS"
"|PALAZZO"	"bedrijfsnaam -JS"
"|ALTAMURA"	"bedrijfsnaam -JS"
"|LARSEN"	"bedrijfsnaam -JS"
"|SERRA"	"bedrijfsnaam -JS"
"|POWELL"	"bedrijfsnaam -JS"
"|HOLDING"	"bedrijfsstructuur -JS"
"|BULUT|YAVUZ"	"beide namen komen veelvuldig voor -JS"
"|TURKMENOGLU|BENEK"	"benek is een veelvoorkomende naam - JS"
"|MAURI"	"bevolking - JS"
"|ROMA"	"bevolking/plaatsnaam - JS"
"|UNISON"	"computerprogramma - JS"
"|DEL SOL"	"costa - JS"
"|BEER"	"dier - JS"
"|MOL"	"dier/gangbare achternaam -JS"
"|SABA"	"eiland - JS"
"|STRETCH"	"Engels woord - JS"
"|STATE"	"Engels woord - JS"
"|YOUNGER"	"Engels woord - JS"
"|RICE"	"engels woord - JS"
"|ONCE"	"engels woord - JS"
"|STRATEGIES"	"engels woord - JS"
"|BUTLER"	"engels woord - JS"
"|CAMP"	"engels woord - JS"
"|CAMPS"	"engels woord - JS"
"|HALL"	"Engels woord - kan in citaat voorkomen -JS"
"|TILL"	"engels woord -JS"
"|SAILER"	"Engels woord -JS"
"|PRETTY"	"Engels woord -JS"
"|GRAND"	"Engels woord -JS"
"|SENSES"	"engels woord -JS"
"|HOLDER"	"Engels woord -JS"
"|RED"	"engels woord -JS"
"|ROCK"	"engels woord -JS"
"|KORAL"	"Engels woord voor koraal en komt voor als naam van een onderneming op rechtspraak - JS"
"|CHAMBERS"	"Engels woord/ kan voorkomen in citaten - JS"
"|CANT"	"Engels woord/ kan voorkomen in citaten - JS"
"|SOY"	"engels woord/kan in citaat voorkomen - JS"
"|PAGES"	"engels woord/kan in citaat voorkomen - JS"
"|PRICE"	"Engels woord/kan in citaat voorkomen - JS"
"|SUMMERS"	"Engels woord/kan in citaat voorkomen -JS"
"|STRATEGIES|COMMUNICATIONS"	"engelse woorden/ kan in citaat voorkomen -JS"
"|MAIRE"	"Frans voor burgemeester/naam bestemmingsplan - JS"
"|SIGNE"	"Frans woord/kan in citaat voorkomen  -JS"
"|JOUBERT"	"gangbare achternaam - JS"
"|MATON"	"gangbare achternaam - JS"
"|AHMADI"	"geloofsgenootschap - JS"
"|GROSSO"	"grosso modo - JS"
"|STAFFORD"	"hondenras - JS"
"|NAPOLITANO"	"hondenras - JS"
"|BERLIN"	"hoofdstad Duitsland -JS"
"|IMAM"	"islamitische leider - JS"
"|BIANCO"	"Italiaans - kan in citaat voorkomen - JS"
"|NERO"	"italiaans woord - kan in citaat voorkomen -JS"
"|APONTE"	"komt voor als aponte v. Nederland -JS"
"|BLAND"	"komt voor als b-land. Wordt dit herkend door LX?"
"|ONER"	"komt voor als spelfout voor 'onder'en als achternaam maar dan met een umlaut op de o - JS"
"|KARNER"	"komt voor als typefout voor kamer - JS"
"|MISCHIE"	"komt voor in citaat - JS"
"|MANERA"	"komt voor in citaat - JS"
"|FABI"	"komt voor in Duits citaat -JS"
"|CARBONE"	"komt voor in Frans citaat -JS"
"|CORSI"	"komt voor in italiaans citaat - JS"
"|SAVANNA"	"landschap - JS"
"|BONA"	"Latijn bv: bona fide -JS"
"|MENTIS"	"Latijns woord -JS"
"|MULTIPLEX"	"materiaal - JS"
"|""MULTIPLEX"""	"materiaal - JS"
"|BROCA"	"medische term - JS"
"|DISCI"	"medische term - JS"
"|WEBER"	"merknaam"
"|HAGER"	"merknaam"
"|LIVINGSTONE"	"merknaam - JS"
"|YAZ"	"merknaam - JS"
"|MADSEN"	"merknaam - JS"
"|GUCCI"	"merknaam - JS"
"|KALASHNIKOV"	"merknaam - JS"
"|FALCONE"	"merknaam - JS"
"|D'AMORE"	"merknaam - JS"
"|MASSIMO"	"merknaam - JS"
"|FERRAZZINI"	"merknaam - JS"
"|VITTORIO"	"merknaam - JS"
"|BAYLISS"	"merknaam - JS"
"|NICOL"	"merknaam - JS"
"|BIBA"	"merknaam - JS"
"|DENTON"	"merknaam -JS"
"|COSTE"	"merknaam -JS"
"|CAROLLA"	"merknaam -JS"
"|SAVONA"	"merknaam -JS"
"|PEPE"	"merknaam -JS"
"|SAPL"	"merknaam -JS"
"|SUTHERLAND"	"merknaam -JS"
"|MIELE"	"merknaam -JS"
"|HAY"	"merknaam -JS"
"|CROUCH"	"naam advocaat"
"|NAGHI"	"naam advocaat - JS"
"|CEKIC"	"naam advocaat - JS"
"|LOYEN"	"naam advocaat - JS"
"|BEUMER"	"naam advocaat - JS"
"|WOUTERSE"	"naam advocaat - JS"
"|BATUR"	"naam advocaat - JS"
"|ORHAN"	"naam advocaat - JS"
"|SKALA"	"naam advocaat - JS"
"|AKCA"	"naam advocaat - JS"
"|PENNINO"	"naam advocaat - JS"
"|CONTE"	"naam advocaat - JS"
"|SAKI"	"naam advocaat - JS"
"|NWOSU"	"naam advocaat - JS"
"|FALCONI"	"naam advocaat - JS"
"|OFFERHAUS"	"naam advocaat - JS"
"|SCHMELZER"	"naam advocaat - JS"
"|ABBAS"	"naam advocaat - JS"
"|BENHAIM"	"naam advocaat -JS"
"|SPERA"	"naam advocaat -JS"
"|KAWKA"	"naam advocaat -JS"
"|VAN NUS"	"naam advocaat -JS"
"|STIX"	"naam A-G - JS"
"|SAGGIO"	"naam A-G - JS"
"|EGGER"	"naam arts - JS"
"|MEFTAH"	"naam arts - JS"
"|POLACEK"	"naam arts - JS"
"|RIZZI"	"naam arts - JS"
"|ROGAN"	"naam arts - JS"
"|HANSSON"	"naam arts -JS"
"|KAMALI"	"naam arts -JS"
"|WURM"	"naam arts -JS"
"|PATEL"	"naam arts -JS"
"|KUCHAR"	"naam arts -JS"
"|BINI"	"naam arts -JS"
"|LUNDE"	"naam arts -JS"
"|WETTSTEIN"	"naam arts -JS"
"|LYONS"	"naam auteur - JS"
"|SELIGMAN"	"naam auteur - JS"
"|SCOTTI"	"naam auteur -JS"
"|ARNARSSON"	"naam auteur -JS"
"|BIONDI"	"naam auteur -JS"
"|DURAND"	"naam auteur -JS"
"|CREDIT BANK"	"naam bank, kan in een andere context voorkomen - JS"
"|TURKAN"	"naam gemachtigde - JS"
"|KOROGLU"	"naam gemachtigde - JS"
"|SANTORO"	"naam gemachtigde - JS"
"|DICKMANN"	"naam gemachtigde - JS"
"|YAMAN"	"naam gemachtigde - JS"
"|TEPE"	"naam gemachtigde - JS"
"|OZKANLI"	"naam gemachtigde - JS"
"|WITCZAK"	"naam gemachtigde - JS"
"|SCHRAMM"	"naam gemachtigde - JS"
"|WENDENBURG"	"naam gemachtigde - JS"
"|DURINGER"	"naam gemachtigde - JS"
"|NARDELLI"	"naam gemachtigde - JS"
"|HENNING"	"naam gemachtigde - JS"
"|ATAKAN"	"naam gemachtigde - JS"
"|ELIAZER"	"naam gemachtigde - JS"
"|HECKER"	"naam gemachtigde - JS"
"|RIGUTTO"	"naam gemachtigde - JS"
"|PIRON"	"naam gemachtigde - JS"
"|CANER"	"naam gemachtigde -JS"
"|IVANKOVIC"	"naam griffier - JS"
"|CARDOSO"	"naam griffier - JS"
"|KIRILLOV"	"naam komt in een ander verband voor - JS"
"|MESTER"	"naam komt in een ander verband voor - JS"
"|BERNHART"	"naam komt in een ander verband voor - JS"
"|ALEKSANDROV"	"naam komt in een ander verband voor - JS"
"|TOSIC"	"naam komt in een ander verband voor - JS"
"|METEL"	"naam komt in een ander verband voor - JS"
"|DINCER"	"naam komt in een ander verband voor - JS"
"|AKCAY"	"naam komt in een ander verband voor - JS"
"|SENGUL"	"naam komt in een ander verband voor - JS"
"|GORGES"	"naam komt in een ander verband voor - JS"
"|WALCZAK"	"naam komt in een ander verband voor - JS"
"|UYGUR"	"naam komt in een ander verband voor - JS"
"|LAINE"	"naam komt in een ander verband voor - JS"
"|GUIDO"	"naam komt in een ander verband voor - JS"
"|KISA"	"naam komt in een ander verband voor - JS"
"|STEFANOV"	"naam komt in een ander verband voor - JS"
"|KEENAN"	"naam komt in een ander verband voor - JS"
"|KUNA"	"naam komt in een ander verband voor - JS"
"|MATERA"	"naam komt in een ander verband voor - JS"
"|GERMANO"	"naam komt in een ander verband voor - JS"
"|ROCCHI"	"naam komt in een ander verband voor - JS"
"|JOLY"	"naam komt in een ander verband voor - JS"
"|BRADY"	"naam komt in een ander verband voor - JS"
"|IVENS"	"naam komt in een ander verband voor - JS"
"|CANTURK"	"naam komt in een ander verband voor - JS"
"|JEFFERSON"	"naam komt in een ander verband voor - JS"
"|SANTINI"	"naam komt in een ander verband voor - JS"
"|PICCOLO"	"naam komt in een ander verband voor - JS"
"|MESSINA"	"naam komt in een ander verband voor - JS"
"|OLDHAM"	"naam komt in een ander verband voor - JS"
"|BUKER"	"naam komt in een ander verband voor - JS"
"|DAMLA"	"naam komt in een ander verband voor - JS"
"|LAGRANGE"	"naam komt in een ander verband voor - JS"
"|CARUSO"	"naam komt in een ander verband voor - JS"
"|SENER"	"naam komt in een ander verband voor - JS"
"|FOSCHINI"	"naam komt in een ander verband voor - JS"
"|LUCIANO"	"naam komt in een ander verband voor - JS"
"|NARCISO"	"naam komt in een ander verband voor - JS"
"|ORSINI"	"naam komt in een ander verband voor - JS"
"|BERNARDO"	"naam komt in een ander verband voor - JS"
"|PALUMBO"	"naam komt in een ander verband voor - JS"
"|NOACK"	"naam komt in een ander verband voor - JS"
"|DOWNING"	"naam komt in een ander verband voor - JS"
"|SERVES"	"naam komt in een ander verband voor - JS"
"|MITTERMAIER"	"naam komt in een ander verband voor - JS"
"|BARANOWSKI"	"naam komt in een ander verband voor - JS"
"|GEORGIOU"	"naam komt in een ander verband voor - JS"
"|VERO"	"naam komt in een ander verband voor - JS"
"|LEARY"	"naam komt in een ander verband voor - JS"
"|CAVUS"	"naam komt in een ander verband voor -JS"
"|SABATINI"	"naam komt in een ander verband voor -JS"
"|MIHALY"	"naam komt in een ander verband voor -JS"
"|KEPA"	"naam komt in een ander verband voor -JS"
"|GUICHARD"	"naam komt in een ander verband voor -JS"
"|KERR"	"naam komt in een ander verband voor -JS"
"|MAIER"	"naam komt in een ander verband voor -JS"
"|DORAN"	"naam komt in een ander verband voor -JS"
"|MOKRANI"	"naam komt in een ander verband voor -JS"
"|AFONSO"	"naam komt in een ander verband voor -JS"
"|BARUT"	"naam komt in een ander verband voor -JS"
"|PERNA"	"naam komt in een ander verband voor -JS"
"|LEMOINE"	"naam komt in een ander verband voor -JS"
"|KOLB"	"naam komt in een ander verband voor -JS"
"|MATTA"	"naam komt in een ander verband voor -JS"
"|BERTUZZI"	"naam komt in een ander verband voor -JS"
"|VORWALD"	"naam komt in een ander verband voor -JS"
"|WILLIS"	"naam komt in een ander verband voor -JS"
"|AUGUST"	"naam komt in een ander verband voor -JS"
"|MANSELL"	"naam komt in een ander verband voor -JS"
"|HAGMAN"	"naam komt in een ander verband voor -JS"
"|SAVIO"	"naam komt in een ander verband voor -JS"
"|FRATTINI"	"naam komt in een ander verband voor -JS"
"|KURAY"	"naam komt in een ander verband voor -JS"
"|PASKA"	"naam komt in een ander verband voor -JS"
"|PISANO"	"naam komt in een ander verband voor -JS"
"|RADOS"	"naam komt in een ander verband voor -JS"
"|DOOMS"	"naam komt in een ander verband voor -JS"
"|LEFEBVRE"	"naam komt in een ander verband voor -JS"
"|MIFSUD"	"naam komt in een ander verband voor -JS"
"|JOHANSEN"	"naam komt in een ander verband voor -JS"
"|SIENA"	"naam komt in een ander verband voor -JS"
"|NEHRU"	"naam komt in een ander verband voor -JS"
"|PILCH"	"naam komt in een ander verband voor -JS"
"|KINGSLEY"	"naam komt in een ander verband voor -JS"
"|PARRIS"	"naam komt in een ander verband voor -JS"
"|OLIVIEIRA"	"naam komt in een ander verband voor -JS"
"|MIREK"	"naam komt in een ander verband voor -JS"
"|UNLU"	"naam komt in een ander verband voor -JS"
"|JOKELA"	"naam komt in een ander verband voor -JS"
"|SEGI"	"naam komt in een ander verband voor -JS"
"|GOTH"	"naam komt in een ander verband voor -JS"
"|CORNEA"	"naam komt in een ander verband voor -JS"
"|BETTI"	"naam komt in een ander verband voor -JS"
"|PRETE"	"naam komt in een ander verband voor -JS"
"|VAN DER KAR"	"naam komt in een ander verband voor -JS"
"|BENZI"	"naam komt in een ander verband voor -JS"
"|PACIFICO"	"naam komt in een ander verband voor -JS"
"|RINALDI"	"naam komt in een ander verband voor -JS"
"|PORTO"	"naam komt in een ander verband voor -JS"
"|ROMANO"	"naam komt in een ander verband voor -JS"
"|AVETISSOV"	"naam komt in een ander verband voor -JS"
"|TANNER"	"naam komt in een ander verband voor -JS"
"|CENTI"	"naam komt in een ander verband voor -JS"
"|GRASSI"	"naam komt in een ander verband voor -JS"
"|PASTORE"	"naam komt in een ander verband voor -JS"
"|CESARO"	"naam komt in een ander verband voor -JS"
"|VOGL"	"naam komt in een ander verband voor -JS"
"|LABUS"	"naam komt in een ander verband voor -JS"
"|ISCI"	"naam komt in een ander verband voor -JS"
"|SUGG"	"naam komt in een ander verband voor -JS"
"|KREPS"	"naam komt in een ander verband voor -JS"
"|DEGER"	"naam komt in een ander verband voor -JS"
"|ORAK"	"naam komt in een ander verband voor -JS"
"|ROMO"	"naam komt in een ander verband voor -JS"
"|ATLAN"	"naam komt in een ander verband voor -JS"
"|CASTIGLIONI"	"naam komt in een ander verband voor -JS"
"|CIRCO"	"naam komt in een ander verband voor -JS"
"|BONELLI"	"naam komt in een ander verband voor -JS"
"|ADRIANI"	"naam komt in een ander verband voor -JS"
"|ATAK"	"naam komt in een ander verband voor -JS"
"|ANTONINI"	"naam komt in een ander verband voor -JS"
"|SAHLI"	"naam komt in een ander verband voor -JS"
"|SIEGEL"	"naam komt in een ander verband voor -JS"
"|VALLE"	"naam komt in een ander verband voor -JS"
"|BLAY"	"naam komt in een ander verband voor -JS"
"|PANOU"	"naam komt voor in een ander verband -JS"
"|FOLLO"	"naam komt voor in een citaat - JS"
"|ALLARD"	"naam museum - JS"
"|POOLE"	"naam rechter - JS"
"|MAHIEU"	"naam rechter - JS"
"|LECLERCQ"	"naam rechter - JS"
"|BEIJE"	"naam rechter - JS"
"|GOLDSTEIN"	"naam rechter - JS"
"|MARI"	"naam schip -JS"
"|SIKO"	"naam school - JS"
"|ALPARSLAN"	"naam school - JS"
"|BAYRAM"	"naam stichting - JS"
"|MORINA"	"naam tolk - JS"
"|BAYSAL"	"naam tolk - JS"
"|PERIE"	"naam tolk - JS"
"|SALAMAN"	"naam tolk -JS"
"|POP"	"NL woord - JS"
"|RAGE"	"nl woord - JS"
"|AKTEN"	"nl woord - JS"
"|DRENK"	"NL woord -JS"
"|MOND"	"NL woord -JS"
"|KIND"	"NL woord -JS"
"|OREN"	"NL woord -JS"
"|VISSER"	"nl woord -JS"
"|SLOTS"	"nl woord -JS"
"|PAAR"	"nl woord -JS"
"|OVER"	"nl woord -JS"
"|TAMMER"	"nl woord -JS"
"|RAT"	"nl woord -JS"
"|PRINCIPE"	"nl woord -JS"
"|KNEL"	"nl woord -JS"
"|VALENTINO"	"ontwerper - JS"
"|DONATO"	"plaatsnaam"
"|KOTOK"	"plaatsnaam - JS"
"|ERBIL"	"plaatsnaam - JS"
"|BOLOGNA"	"plaatsnaam - JS"
"|GURUN"	"plaatsnaam - JS"
"|SAN JUAN"	"plaatsnaam - JS"
"|SANTAGATA"	"plaatsnaam - JS"
"|JERUSALEM"	"plaatsnaam - JS"
"|CATANIA"	"plaatsnaam - JS"
"|MARLOW"	"plaatsnaam - JS"
"|LACOMBE"	"plaatsnaam - JS"
"|HELLUM"	"plaatsnaam - JS"
"|DERBYSHIRE"	"plaatsnaam -JS"
"|KAYSERI"	"plaatsnaam -JS"
"|AUSTIN"	"plaatsnaam -JS"
"|GENTILE"	"plaatsnaam -JS"
"|AKYAZI"	"plaatsnaam -JS"
"|PARIS"	"plaatsnaam -JS"
"|FRANCO"	"post - jS"
"|BABEL"	"provincie Irak - JS"
"|ROEMEN"	"spelfout voor Roemenen"
"|STANFORD"	"universiteit -JS"
"|FINSTER"	"veel voorkomende bedrijfsnaam en titel voor een structuurvisie op rechtspraak - JS"
"|DENNIS"	"veel voorkomende voornaam - JS"
"|AKBAR"	"veelvoorkomend citaat op rechtspraak 'allah akbar' - JS"
"|MILLS"	"veelvoorkomende achternaam - JS"
"|ERNST"	"veelvoorkomende achternaam - JS"
"|POLMAN"	"veelvoorkomende achternaam - JS"
"|MALEK"	"veelvoorkomende achternaam - JS"
"|VERHAEGHE"	"veelvoorkomende achternaam - JS"
"|WALLER"	"veelvoorkomende achternaam - JS"
"|VENEMA"	"veelvoorkomende achternaam - JS"
"|GREUTER"	"veelvoorkomende achternaam - JS"
"|RUTTEN"	"veelvoorkomende achternaam - JS"
"|MARSHALL"	"veelvoorkomende achternaam - JS"
"|CHARLES"	"veelvoorkomende achternaam - JS"
"|ZANDER"	"veelvoorkomende achternaam - JS"
"|BRUNNO"	"veelvoorkomende achternaam - JS"
"|GARCIA"	"veelvoorkomende achternaam - JS"
"|BAKER"	"veelvoorkomende achternaam - JS"
"|SOLOMON"	"veelvoorkomende achternaam - JS"
"|VAN PELT"	"veelvoorkomende achternaam - JS"
"|SCHEPER"	"veelvoorkomende achternaam - JS"
"|BOONS"	"veelvoorkomende achternaam - JS"
"|BAARS"	"veelvoorkomende achternaam -JS"
"|RILEY"	"veelvoorkomende achternaam -JS"
"|AKKAS"	"veelvoorkomende achternaam -JS"
"|WILLEKENS"	"veelvoorkomende achternaam -JS"
"|VAN DER VEN"	"veelvoorkomende achternaam -JS"
"|MITCHELL"	"veelvoorkomende achternaam -JS"
"|HOPPE"	"veelvoorkomende achternaam -JS"
"|NIXON"	"veelvoorkomende achternaam -JS"
"|PARSONS"	"veelvoorkomende achternaam -JS"
"|ADAMS"	"veelvoorkomende achternaam -JS"
"|YOUSEF"	"veelvoorkomende achternaam -JS"
"|ALLAN"	"veelvoorkomende achternaam -JS"
"|HEWITT"	"veelvoorkomende achternaam -JS"
"|ANDERSEN"	"veelvoorkomende achternaam -JS"
"|MEULENDIJKS"	"veelvoorkomende achternaam -JS"
"|KLEUVER"	"veelvoorkomende achternaam -JS"
"|PEERS"	"veelvoorkomende achternaam -JS"
"|SCHEELE"	"veelvoorkomende achternaam -JS"
"|DE BRUIJN"	"veelvoorkomende achternaam -JS"
"|WATSON"	"veelvoorkomende achternaam -JS"
"|MATHURIN"	"veelvoorkomende achternaam -JS"
"|SCHUMAN"	"veelvoorkomende achternaam -JS"
"|COSTER"	"veelvoorkomende achternaam -JS"
"|KASPERS"	"veelvoorkomende achternaam -JS"
"|GOEDHART"	"veelvoorkomende achternamen - JS"
"|STROEK"	"veelvoorkomende achternamen - JS"
"|ERDOGAN|ERDOGAN"	"veelvoorkomende achternamen - JS"
"|ROSA"	"veelvoorkomende naam"
"|SMITH|SMITH"	"veelvoorkomende naam"
"|BRUNO"	"veelvoorkomende naam  -JS"
"|ARENDS"	"veelvoorkomende naam  -JS"
"|JANSSEN"	"veelvoorkomende naam  -JS"
"|DENTE"	"veelvoorkomende naam - JS"
"|BABER"	"veelvoorkomende naam - JS"
"|SERGI"	"veelvoorkomende naam - JS"
"|ADRIAN"	"veelvoorkomende naam - JS"
"|KEMPERS"	"veelvoorkomende naam - JS"
"|ULLAH"	"veelvoorkomende naam - JS"
"|VEN"	"veelvoorkomende naam - JS"
"|ALBERTI"	"veelvoorkomende naam -JS"
"|SAEED"	"veelvoorkomende naam -JS"
"|ANTOINE"	"veelvoorkomende voornaam - JS"
"|JULIEN"	"veelvoorkomende voornaam - JS"
"|JAMES"	"veelvoorkomende voornaam - JS"
"|SELIM"	"veelvoorkomende voornaam - JS"
"|MARCEL"	"veelvoorkomende voornaam - JS"
"|SANDER"	"veelvoorkomende voornaam - JS"
"|THIEME"	"veelvoorkomende voornaam -JS"
"|SIMONE"	"veelvoorkomende voornaam -JS"
"|PASCALE"	"veelvoorkomende voornaam -JS"
"|ROBERTO"	"veelvoorkomende voornaam -JS"
"|JAKOB"	"veelvoorkomende voornaam -JS"
"|LEONI"	"veelvoorkomende voornaam -JS"
"|CAMILLA"	"veelvoorkomende voornaam -JS"
"|JATAIRWAYS"	"vliegmaatschappij - JS"
"|VALK"	"vogel - JS"
"|A. Sh."	"voorletters - JS"
"|C. S.p.a."	"voorletters - JS"
"|M. S.R.L."	"voorletters - JS"
"|F. S.P.A."	"voorletters - JS"
"|Fr.C."	"voorletters - JS"
"|M.Ce."	"voorletters - JS"
"|M.A. P."	"voorletters - JS"
"|G.H. B."	"voorletters - JS"
"|F. J.|E.B."	"voorletters - JS"
"|W.I.E. S.N.C."	"voorletters - JS ??"
"|C. ar.l."	"voorletters - JS ??"
"|AN.M."	"voorletters -JS"
"|H.C."	"voorletters -JS"
"|OL.B."	"voorletters/afkorting - JS"
"|I.Fr."	"voorletters/afkorting -JS"
"|JANUS"	"voornaam - JS"
"|MORTIER"	"wapen - JS"
"|GOK"	"werkwoork 'gokken' - JS"
"|ARMSTRONG"	"wielrenners -JS"
"|POTAS"	"zoutoplossing"
"|ELDER"	"Engels woord"
"|SELLIER"	"soort patroon - ST"
"|C. SRL"	"afkorting - ST"
"|TARANTINO"	"naam bekende regisseur - ST"
"|AYDOGDU"	"naam psycholoog - ST"
"|VAN"	"voorzetsel - ST"
"|REICHMAN"	"veelvoorkomende naam - ST"
"|HUNDE"	"duits woord voor hond - ST"
"|STRACK"	"naam advocaat-generaal - ST"
"|KAGIA"	"naam voetbalvereniging - ST"
"|CABRAL"	"plaatsnaam - ST"
"|J?RGENSEN"	"geweermodel - ST"
"|HAMI"	"naam advocaat - ST"
"|SZIJJARTO"	"Hongaarse minister van Buitenlandse Zaken - ST"
"|EZE"	"Komt veel voor als typo van 'deze' - ST"
"|LASZLO"	"arrest HvJ - ST"
"|RIAHI"	"Naam (ander) persoon - ST"
"|MERCAN"	"Naam (ander) persoon - ST"
"|SCHUTZ"	"naam advocaat - ST"
"|DEMIRKOL"	"naam uitzendbureau - ST"
"|GOTHARD"	"naam bank - ST"
"|TENCE"	"naam uitzendbureau - ST"
"|MERGEN"	"naam griffier - ST"
"|?UKASZEWICZ"	"naam advocaat - ST"
"|LOOG"	"verleden tijd van 'lieg' - ST"
"|TROFIN"	"naam bedrijf - ST"
"|LIGA PORTUGUESA DE FUTEBOL PROFISSIONAL"	"arrest HvJ - ST"
"|VAN VELZEN"	"veelvoorkomende naam - ST"
"|MC INNES"	"naam bedrijf - ST"
"|LEM"	"naam advocaat - ST"
"|CASTELIJNS"	"veelvoorkomende naam - ST"
"|SMETSERS"	"veelvoorkomende naam - ST"
"|LACROIX"	"veelvoorkomende naam - ST"
"|MURA"	"naam bedrijf - ST"
"|DWORZECKI"	"arrest HvJ - ST"
"|VASILJEVIC"	"arrest ICTY - ST"
"|SETON"	"naam advocaat - ST"
"|LITVINOV"	"plaatsnaam - ST"
"|KARS"	"veelvoorkomende naam - ST"
"|PALMEN"	"soort boom - ST"
"|MEYER"	"veelvoorkomende naam - ST"
"|KAHN"	"naam deskundige - ST"
"|GILLISSEN"	"naam advocaat - ST"
"|JOKIC"	"naam ander arrest - ST"
"|AYAR"	"naam rechter - ST"
"|ERMIS"	"bedrijfsnaam - ST"
"|ECHTER"	"voegwoord - ST"
"|PRADE"	"naam advocaat - ST"
"|LEGAL"	"engels woord voor 'legaal' - ST"
"|PERAK"	"plaatsnaam - ST"
"|DEMIRAL"	"naam griffier - ST"
"|NASR"	"naam en wetsafkorting - ST"
"|CAM"	"naam en afkorting - ST"
"|WAHL"	"naam en duits woord - ST"
"|DOHERTY"	"veelvoorkomende naam - ST"
"|BEAUSOLEIL"	"Plaats in Frankrijk - ST"
"|KALANDIA"	"Plaats in Palestina - ST"
"|MOOG"	"Instrument - ST"
"|RUBIN"	"Veelvoorkomende naam - ST"
"|CORLAN"	"Naam medicijn - ST"
"|VOLTMAN"	"Veelvoorkomende naam - ST"
"|MUHAMMED"	"Veelvoorkomende naam - ST"
"|BODA"	"Veelvoorkomende bedrijfsnaam - ST"
"|OTGON"	"Plaats in MongoliÃ«"
"|ARPS"	"Naam rechter"
"|TEICA"	"Naam bedrijf"
"|RUSYN"	"Naam ethische groepering"
"|MIZRAK"	"Naam getuige"
"|RACZ"	"Naam medische behandeling"
"|MIHAYLOV"	"Naam bedrijfsarts"
"|BEGO"	"Naam vastgoedbedrijf - ST"
"|NAKU"	"Plaats in IndonesiÃ« - ST"
"|YABLOKO RUSSIAN UNITED DEMOCRATIC PARTY"	"Russische politieke partij - ST"
"|ZADONSKIY"	"Gebied in Rusland - ST"
"|GUTAU"	"Gemeente in Oostenrijk - ST"
"|ARION"	"Veelvoorkomende naam voor bedrijven - ST"
"|VARDANYAN"	"Naam komt in ander arrest voor - ST"
"|GREBNEVA"	"Grens punt - ST"
"|HILLER"	"Veelvoorkomende naam - ST"
"|KERMAN"	"Stad in Iran - ST"
"|ANTSIFEROV"	"Eiland in Rusland - ST"
"|SARIHAN"	"Plaats in Turkije - ST"
"|TOMINA"	"Naam tolk - ST"
"|SALEM"	"Veelvoorkomende naam - ST"
"|TIBA"	"Bedrijfsnaam/afkorting - ST"
"|FRIDA"	"Voornaam - ST"
"|KOLBASOV"	"Gemeente in Slowakije - ST"
"|PIU"	"Bedrijfsnaam - ST"
"|KEBE"	"Naam tolk - ST"
"|LABORIE"	"Plaats in Saint Lucia - ST"
"|IRFAN GUZEL"	"Komt in andere zaak voor - ST"
"|MKHCHYAN"	"Dorp in ArmeniÃ« - ST"
"|IGBO"	"Nigeriaanse stam/taal - ST"
"|MESSANA"	"Stad in ItaliÃ« - ST"
"|SOLARINO"	"Gemeente in ItaliÃ« - ST"
"|DOLGANIN"	"Bevolkingsgroep - ST"
"|HOKKELING"	"Veelvoorkomende naam - ST"
"|FAGARAS"	"Stad in RoemeniÃ« - ST"
"|PAROUTSAS"	"Komt in andere context voor - ST"
"|TALPIS"	"Komt in andere context voor - ST"
"|MANOLI"	"Bedrijfsnaam - ST"
"|ILIAS"	"Naam Stichting - ST"
"|WOLTER"	"Veelvoorkomende naam - ST"
"|SAYENKO"	"Naam dokter - ST"
"|ANEVA"	"Bedrijfsnaam - ST"
"|SARUR"	"Plaats in Iran - ST"
"|SOMMER"	"Veelvoorkomende naam - ST"
"|CELA"	"Frans voor 'dit' - ST"
"|POLITI"	"Lijkt te veel op 'politie' - ST"
"|VALANCIENE"	"Plaats in Frankrijk - ST"
"|USTINOV"	"Naam advocaat - ST"
"|GEVAL"	"In het geval van ... - ST"
"|KURS"	"Duits voor 'cursus' - ST"
"|VAN WESENBEECK"	"Naam rechter - ST"
"|BLAIR"	"Oud premier UK"
"|ACHIM"	"plaats in Duitsland"
"|LEBOIS"	"auteur"
"|TEL"	"een twee drie"
"|NEDIC"	"Bedrijf"
"|SAZAS"	"IN NL bekende naam"
"|ABELE"	"naam"
"|SILVA"	"naam en zo"
"|RAU"	"Van alles"
"|MAKEDON"	"Naam van boot"
"|FEJZIC"	"komt voor in ECLI:NL:PHR:2012:BW1999"
"|GVOZDIC"	"Advocaat"
"|BODO"	"gemeente ergens"
"|SEVERE"	"Engels woord"
"|CESUR"	"Bedrijf"
"|THOR"	"Van alles"
"|STOLLENWERK"	"Naam"
"|RITZ"	"hotel en zo"
"|RAJIC"	"Ook zaak van joegoslavie tribunaal"
"|ROBU"	"bedrijf"
"|KOKEN"	"mjammie!"
"|JULA"	"naam"
"|SELINA"	"naam"
"|RASTORGUYEV"	"partijnaam"
"|LORENZ"	"van alles"
"|XENOS"	"winkel"
"|RUTA"	"naam"
"|BECHT"	"Naam"
"|GALEA"	"bedrijfsnaam"
"|GARD"	"van alles"
"|PIRAS"	"naam"
"|OGUZHAN"	"Naam"
"|HARKINS"	"Naam"
"|LEITNER"	"bedrijf"
"|SCHWAB"	"naam"
"|BAR"	"nederlands woord"
"|SEVERINI"	"naam"
"|ANCA"	"Bedrijfsnaam - ST"
"|POCA"	"Internationale wet - ST"
"|COLGECEN"	"Naam advocaat - ST"
"|DIK"	"Tegenovergesteld van dun - ST"
"|BORSAN"	"Roemeense naam - ST"
"|RESIN"	"Cannabis soort - ST"
"|JAN"	"Veelvoorkomende voornaam - ST"
"|HAARDE"	"Plaatsnaam - ST"
"|TADIC"	"Arrest ICTY - ST"
"|JURIS"	"Naam bedrijf - ST"
"|DEMO"	"Soort geluidsopname - ST"
"|MANSOUR"	"Wijk in Bagdad - ST"
"|HARVEY"	"Veelvoorkomende naam - ST"
"|ENON"	"Naam bedrijf - ST"
"|LUTOVA"	"Plaats in TsjechiÃ« - ST"
"|SIDOROVA"	"Naam tolk - ST"
"|OLTEAN"	"Naam advocaat - ST"
"|AFANASYEVA"	"Naam deskundige - ST"
